Area_Name,Year,Group_Name,Sub_Group_Name,Cases_Acquitted_or_Discharged,Cases_charge_sheets_were_not_laid_but_Final_Report_submitted,Cases_Chargesheeted,Cases_Compounded_or_Withdrawn,Cases_Convicted,Cases_Declared_False_on_Account_of_Mistake_of_Fact_or_of_Law,Cases_Investigated_Chargesheets+FR_Submitted,Cases_not_Investigated_or_in_which_investigation_was_refused,Cases_Pending_Investigation_at_Year_End,Cases_Pending_Investigation_from_previous_year,Cases_Pending_Trial_at_Year_End,Cases_Pending_Trial_from_the_previous_year,Cases_Reported,Cases_Sent_for_Trial,Cases_Trials_Completed,Cases_Withdrawn_by_the_Govt,Cases_withdrawn_by_the_Govt_during_investigation,Total_Cases_for_Trial
Andaman & Nicobar Islands,2001,Rape,01. Rape,5,2,3,0,0,0,5,0,1,3,34,36,3,3,5,0,0,39
Andhra Pradesh,2001,Rape,01. Rape,731,22,769,35,197,74,791,3,393,390,1974,2170,871,769,928,2,0,2937
Arunachal Pradesh,2001,Rape,01. Rape,1,2,25,0,2,0,27,0,18,12,282,260,33,25,3,0,0,285
Assam,2001,Rape,01. Rape,334,95,495,10,101,45,590,0,1045,863,1964,1914,817,495,435,0,0,2409
Bihar,2001,Rape,01. Rape,406,141,685,0,155,105,826,0,488,531,3185,3061,888,685,561,0,0,3746
Chandigarh,2001,Rape,01. Rape,9,0,16,0,2,2,16,0,1,1,34,29,18,16,11,0,0,45
Chhattisgarh,2001,Rape,01. Rape,520,15,976,1,158,11,991,1,86,130,3966,3669,959,976,678,0,0,4645
Dadra & Nagar Haveli,2001,Rape,01. Rape,0,0,8,0,1,0,8,0,1,3,21,14,6,8,1,0,0,22
Daman & Diu,2001,Rape,01. Rape,3,0,1,0,0,0,1,0,0,1,1,3,0,1,3,0,0,4
Delhi,2001,Rape,01. Rape,80,65,361,0,29,1,426,0,197,243,1651,1399,381,361,109,0,0,1760
Goa,2001,Rape,01. Rape,10,1,14,0,10,0,15,0,5,8,47,53,12,14,20,0,0,67
Gujarat,2001,Rape,01. Rape,150,10,288,7,26,10,298,1,24,47,1948,1843,286,288,176,0,0,2131
Haryana,2001,Rape,01. Rape,291,6,341,1,94,54,347,0,22,25,636,681,398,341,385,0,0,1022
Himachal Pradesh,2001,Rape,01. Rape,75,0,110,0,30,25,110,0,35,46,389,384,124,110,105,0,0,494
Jammu & Kashmir,2001,Rape,01. Rape,98,4,147,5,7,26,151,0,49,57,570,533,169,147,105,0,0,680
Jharkhand,2001,Rape,01. Rape,236,49,404,0,99,11,453,0,185,82,1034,965,567,404,335,0,0,1369
Karnataka,2001,Rape,01. Rape,154,17,271,8,41,24,288,4,99,122,1132,1064,293,271,195,0,0,1335
Kerala,2001,Rape,01. Rape,111,11,510,3,32,22,521,10,505,496,2190,1826,562,510,143,0,0,2336
Lakshadweep,2001,Rape,01. Rape,0,0,1,0,0,0,1,0,0,1,1,0,0,1,0,0,0,1
Madhya Pradesh,2001,Rape,01. Rape,2052,188,2616,25,589,16,2804,9,261,264,6721,6771,2851,2616,2641,0,25,9387
Maharashtra,2001,Rape,01. Rape,727,21,1289,17,125,20,1310,0,230,258,9876,9456,1302,1289,852,0,0,10745
Manipur,2001,Rape,01. Rape,1,20,4,0,0,0,24,0,33,37,39,36,20,4,1,0,0,40
Meghalaya,2001,Rape,01. Rape,11,8,21,0,0,0,29,0,64,67,236,226,26,21,11,0,0,247
Mizoram,2001,Rape,01. Rape,10,0,51,0,32,0,51,0,14,13,96,87,52,51,42,0,0,138
Nagaland,2001,Rape,01. Rape,2,3,8,1,2,0,11,0,19,13,48,45,17,8,4,0,0,53
Odisha,2001,Rape,01. Rape,408,22,769,0,117,40,791,1,268,310,2354,2110,790,769,525,0,0,2879
Puducherry,2001,Rape,01. Rape,0,0,8,0,0,0,8,0,4,3,16,8,9,8,0,0,0,16
Punjab,2001,Rape,01. Rape,171,29,239,1,81,32,268,0,75,77,235,249,298,239,252,0,0,488
Rajasthan,2001,Rape,01. Rape,700,7,771,13,266,320,778,0,78,127,2614,2822,1049,771,966,0,0,3593
Sikkim,2001,Rape,01. Rape,2,0,5,0,1,0,5,0,3,0,7,5,8,5,3,0,0,10
Tamil Nadu,2001,Rape,01. Rape,160,18,397,3,84,30,415,11,247,280,1288,1138,423,397,244,0,0,1535
Tripura,2001,Rape,01. Rape,38,5,63,1,13,0,68,0,67,33,129,118,102,63,51,0,0,181
Uttar Pradesh,2001,Rape,01. Rape,622,152,1613,15,697,215,1765,0,192,214,5616,5337,1958,1613,1319,0,0,6950
Uttarakhand,2001,Rape,01. Rape,34,3,58,2,30,10,61,0,9,6,157,165,74,58,64,0,0,223
West Bengal,2001,Rape,01. Rape,517,133,717,0,45,1,850,0,777,919,5081,4926,709,717,562,0,0,5643
Andaman & Nicobar Islands,2002,Rape,01. Rape,2,0,3,0,1,0,3,0,0,1,34,34,2,3,3,0,0,37
Andhra Pradesh,2002,Rape,01. Rape,650,23,881,20,120,74,904,0,417,393,2065,1974,1002,881,770,0,0,2855
Arunachal Pradesh,2002,Rape,01. Rape,3,5,32,0,0,0,37,0,19,18,311,282,38,32,3,0,0,314
Assam,2002,Rape,01. Rape,247,134,624,13,99,25,758,0,1232,1045,2229,1964,970,624,346,0,0,2588
Bihar,2002,Rape,01. Rape,383,128,687,0,116,114,815,0,599,488,3373,3185,1040,687,499,0,0,3872
Chandigarh,2002,Rape,01. Rape,5,1,12,0,1,0,13,0,6,1,40,34,18,12,6,0,0,46
Chhattisgarh,2002,Rape,01. Rape,1081,4,986,140,585,21,990,5,62,86,3146,3966,992,986,1666,0,0,4952
Dadra & Nagar Haveli,2002,Rape,01. Rape,12,0,3,0,2,0,3,0,2,1,10,21,4,3,14,0,0,24
Daman & Diu,2002,Rape,01. Rape,0,0,0,0,0,0,0,0,0,0,0,0,0,0,0,0,0,0
Delhi,2002,Rape,01. Rape,344,21,388,0,98,3,409,1,187,197,1597,1651,403,388,442,0,0,2039
Goa,2002,Rape,01. Rape,6,2,8,0,8,0,10,0,7,5,41,47,12,8,14,0,0,55
Gujarat,2002,Rape,01. Rape,184,14,244,13,39,4,258,0,29,24,1956,1948,267,244,223,0,0,2192
Haryana,2002,Rape,01. Rape,288,3,316,1,92,54,319,0,10,22,571,636,361,316,380,0,0,952
Himachal Pradesh,2002,Rape,01. Rape,86,1,112,1,22,14,113,0,45,35,392,389,137,112,108,0,0,501
Jammu & Kashmir,2002,Rape,01. Rape,125,14,156,3,11,23,170,0,48,49,587,570,192,156,136,0,0,726
Jharkhand,2002,Rape,01. Rape,438,65,589,9,132,31,654,0,342,230,2277,2267,797,589,570,0,0,2856
Karnataka,2002,Rape,01. Rape,190,9,277,1,35,6,286,4,95,99,1183,1132,292,277,225,0,0,1409
Kerala,2002,Rape,01. Rape,141,10,445,7,29,13,455,4,532,505,2458,2190,499,445,170,0,0,2635
Lakshadweep,2002,Rape,01. Rape,0,0,0,0,1,0,0,0,1,0,0,1,1,0,1,0,0,1
Madhya Pradesh,2002,Rape,01. Rape,1837,50,2804,32,548,102,2854,3,193,261,7106,6721,2891,2804,2385,2,0,9523
Maharashtra,2002,Rape,01. Rape,1011,32,1288,16,163,17,1320,0,245,230,9974,9876,1352,1288,1174,0,0,11164
Manipur,2002,Rape,01. Rape,0,9,7,0,0,0,16,1,30,33,46,39,14,7,0,0,0,46
Meghalaya,2002,Rape,01. Rape,2,7,17,1,0,0,24,0,78,64,250,236,38,17,2,0,0,253
Mizoram,2002,Rape,01. Rape,10,2,53,0,22,0,55,0,32,11,106,85,76,53,32,0,0,138
Nagaland,2002,Rape,01. Rape,0,2,14,0,7,0,16,0,20,19,55,48,17,14,7,0,0,62
Odisha,2002,Rape,01. Rape,368,10,633,0,105,35,643,0,281,268,2514,2354,691,633,473,0,0,2987
Puducherry,2002,Rape,01. Rape,1,0,3,0,2,0,3,0,7,4,16,16,6,3,3,0,0,19
Punjab,2002,Rape,01. Rape,185,14,255,0,76,31,269,0,74,75,229,235,299,255,261,0,0,490
Rajasthan,2002,Rape,01. Rape,746,10,668,13,287,350,678,0,101,78,2236,2614,1051,668,1033,0,0,3282
Sikkim,2002,Rape,01. Rape,4,4,3,0,4,0,7,0,2,3,2,7,6,3,8,0,0,10
Tamil Nadu,2002,Rape,01. Rape,324,3,471,3,121,28,474,7,271,247,1311,1288,534,471,445,0,1,1759
Tripura,2002,Rape,01. Rape,43,12,95,1,23,0,107,0,68,67,157,129,108,95,66,0,0,224
Uttar Pradesh,2002,Rape,01. Rape,767,87,1282,20,708,184,1369,0,54,192,5403,5616,1415,1282,1475,0,0,6898
Uttarakhand,2002,Rape,01. Rape,35,3,69,0,32,12,72,0,14,9,159,157,89,69,67,0,0,226
West Bengal,2002,Rape,01. Rape,373,113,842,0,63,6,955,0,575,777,5487,5081,759,842,436,0,0,5923
Andaman & Nicobar Islands,2003,Rape,01. Rape,3,0,1,0,3,0,1,0,1,0,29,34,2,1,6,0,0,35
Andhra Pradesh,2003,Rape,01. Rape,641,11,823,5,122,75,834,8,446,417,2120,2065,946,823,763,0,0,2888
Arunachal Pradesh,2003,Rape,01. Rape,0,6,29,1,0,0,35,0,15,19,339,311,31,29,0,0,0,340
Assam,2003,Rape,01. Rape,355,181,769,17,105,70,950,4,1303,1232,2521,2229,1095,769,460,0,0,2998
Bihar,2003,Rape,01. Rape,493,119,592,0,148,99,711,0,774,599,3324,3373,985,592,641,0,0,3965
Chandigarh,2003,Rape,01. Rape,10,1,21,0,7,0,22,0,2,6,44,40,18,21,17,0,0,61
Chhattisgarh,2003,Rape,01. Rape,445,13,838,51,252,19,851,2,88,62,3237,3147,898,838,697,0,0,3985
Dadra & Nagar Haveli,2003,Rape,01. Rape,2,1,0,0,1,1,1,0,1,2,7,10,1,0,3,0,0,10
Daman & Diu,2003,Rape,01. Rape,0,1,2,0,0,0,3,0,2,0,3,1,5,2,0,0,0,3
Delhi,2003,Rape,01. Rape,403,27,460,0,114,3,487,4,181,187,1540,1597,490,460,517,0,2,2057
Goa,2003,Rape,01. Rape,11,2,13,1,7,0,15,0,23,7,35,41,31,13,18,0,0,54
Gujarat,2003,Rape,01. Rape,205,15,216,4,24,9,231,0,25,29,1939,1956,236,216,229,0,0,2172
Haryana,2003,Rape,01. Rape,269,9,288,0,94,47,297,0,19,10,496,571,353,288,363,0,0,859
Himachal Pradesh,2003,Rape,01. Rape,94,2,106,0,28,18,108,0,45,45,376,392,126,106,122,0,0,498
Jammu & Kashmir,2003,Rape,01. Rape,79,1,168,3,9,21,169,0,69,48,664,587,211,168,88,0,0,755
Jharkhand,2003,Rape,01. Rape,395,70,509,7,131,22,579,0,453,342,2095,2277,712,509,526,158,0,2628
Karnataka,2003,Rape,01. Rape,248,8,268,1,39,29,276,7,104,95,1163,1183,321,268,287,0,0,1451
Kerala,2003,Rape,01. Rape,185,6,409,3,45,24,415,7,480,532,2629,2458,394,409,230,5,0,2862
Lakshadweep,2003,Rape,01. Rape,0,0,1,0,0,0,1,0,2,1,1,0,2,1,0,0,0,1
Madhya Pradesh,2003,Rape,01. Rape,2110,44,2580,54,604,90,2624,0,209,185,6754,6942,2738,2580,2714,0,0,9522
Maharashtra,2003,Rape,01. Rape,994,34,1203,29,190,17,1237,0,259,245,9964,9974,1268,1203,1184,0,0,11177
Manipur,2003,Rape,01. Rape,2,9,3,0,1,0,12,0,36,30,46,46,18,3,3,0,0,49
Meghalaya,2003,Rape,01. Rape,2,4,18,0,2,0,22,0,96,78,264,250,40,18,4,0,0,268
Mizoram,2003,Rape,01. Rape,4,3,69,0,18,0,72,0,14,32,153,106,54,69,22,0,0,175
Nagaland,2003,Rape,01. Rape,2,4,12,1,7,0,16,0,18,20,57,55,14,12,9,0,0,67
Odisha,2003,Rape,01. Rape,416,13,707,0,123,53,720,0,233,281,2682,2514,725,707,539,0,0,3221
Puducherry,2003,Rape,01. Rape,0,0,3,0,1,0,3,1,5,7,18,16,2,3,1,0,0,19
Punjab,2003,Rape,01. Rape,210,18,273,2,108,31,291,1,131,74,182,229,380,273,318,0,0,502
Rajasthan,2003,Rape,01. Rape,636,9,649,12,283,349,658,0,144,101,1954,2236,1050,649,919,0,0,2885
Sikkim,2003,Rape,01. Rape,2,0,8,0,1,0,8,0,4,2,7,2,10,8,3,0,0,10
Tamil Nadu,2003,Rape,01. Rape,340,20,477,1,115,23,497,2,303,269,1330,1309,557,477,455,0,1,1786
Tripura,2003,Rape,01. Rape,37,16,99,0,14,0,115,0,67,68,205,157,114,99,51,0,0,256
Uttar Pradesh,2003,Rape,01. Rape,654,34,719,6,682,112,753,0,100,54,4780,5403,911,719,1336,0,0,6122
Uttarakhand,2003,Rape,01. Rape,43,7,86,0,32,10,93,0,18,14,170,159,107,86,75,0,0,245
West Bengal,2003,Rape,01. Rape,394,53,784,0,113,15,837,1,724,575,5764,5487,1002,784,507,0,0,6271
Andaman & Nicobar Islands,2004,Rape,01. Rape,4,0,4,0,0,0,4,0,7,1,29,29,10,4,4,0,0,33
Andhra Pradesh,2004,Rape,01. Rape,752,43,755,7,137,47,798,4,613,446,1979,2120,1016,755,889,0,0,2875
Arunachal Pradesh,2004,Rape,01. Rape,1,8,27,0,4,0,35,0,22,15,361,339,42,27,5,0,0,366
Assam,2004,Rape,01. Rape,455,173,793,28,127,72,966,0,1436,1303,2704,2521,1171,793,582,0,0,3314
Bihar,2004,Rape,01. Rape,652,165,656,0,97,137,821,0,1206,774,3231,3324,1390,656,749,0,0,3980
Chandigarh,2004,Rape,01. Rape,13,2,17,0,0,1,19,0,1,2,48,44,19,17,13,0,0,61
Chhattisgarh,2004,Rape,01. Rape,511,11,941,441,240,26,952,1,78,88,2986,3237,969,941,751,0,0,4178
Dadra & Nagar Haveli,2004,Rape,01. Rape,5,0,5,0,0,0,5,0,3,1,7,7,7,5,5,0,0,12
Daman & Diu,2004,Rape,01. Rape,0,0,3,0,0,0,3,0,0,2,6,3,1,3,0,0,0,6
Delhi,2004,Rape,01. Rape,499,20,432,0,98,73,452,3,204,181,1375,1540,551,432,597,0,0,1972
Goa,2004,Rape,01. Rape,10,6,33,1,7,0,39,0,21,23,50,35,37,33,17,0,0,68
Gujarat,2004,Rape,01. Rape,232,17,307,3,40,14,324,0,26,25,1971,1939,339,307,272,0,0,2246
Haryana,2004,Rape,01. Rape,222,5,337,0,93,41,342,0,22,19,518,496,386,337,315,0,0,833
Himachal Pradesh,2004,Rape,01. Rape,81,6,133,0,26,24,139,0,35,45,402,376,153,133,107,0,0,509
Jammu & Kashmir,2004,Rape,01. Rape,92,11,175,4,12,20,186,0,81,69,731,664,218,175,104,0,0,839
Jharkhand,2004,Rape,01. Rape,395,70,509,7,131,22,579,0,649,453,1913,2095,797,509,526,158,0,2446
Karnataka,2004,Rape,01. Rape,297,5,270,5,64,14,275,4,100,104,1066,1163,291,270,361,1,2,1432
Kerala,2004,Rape,01. Rape,260,13,390,6,56,22,403,6,529,480,2696,2629,480,390,316,1,0,3018
Lakshadweep,2004,Rape,01. Rape,0,0,2,0,1,0,2,0,0,2,1,0,0,2,1,0,0,2
Madhya Pradesh,2004,Rape,01. Rape,2130,31,2815,37,669,83,2846,0,155,209,6733,6754,2875,2815,2799,0,0,9569
Maharashtra,2004,Rape,01. Rape,1033,29,1261,17,227,23,1290,0,334,259,9948,9964,1388,1261,1260,0,0,11225
Manipur,2004,Rape,01. Rape,2,11,2,0,0,0,13,0,54,36,46,46,31,2,2,0,0,48
Meghalaya,2004,Rape,01. Rape,2,6,24,0,2,0,30,0,120,96,284,264,54,24,4,0,0,288
Mizoram,2004,Rape,01. Rape,20,5,15,1,100,0,20,0,14,14,47,153,20,15,120,0,0,168
Nagaland,2004,Rape,01. Rape,0,0,29,0,40,0,29,0,7,18,46,57,18,29,40,0,0,86
Odisha,2004,Rape,01. Rape,550,20,679,0,116,31,699,0,273,233,2695,2682,770,679,666,0,0,3361
Puducherry,2004,Rape,01. Rape,2,0,4,0,2,0,4,0,5,5,18,18,4,4,4,0,0,22
Punjab,2004,Rape,01. Rape,204,24,333,2,93,24,357,1,139,131,216,182,390,333,297,0,0,515
Rajasthan,2004,Rape,01. Rape,545,9,736,15,208,324,745,0,113,144,1922,1954,1038,736,753,0,0,2690
Sikkim,2004,Rape,01. Rape,1,0,2,1,2,0,2,0,5,4,5,7,3,2,3,0,0,9
Tamil Nadu,2004,Rape,01. Rape,317,17,570,21,107,40,587,4,290,303,1455,1330,618,570,424,0,0,1900
Tripura,2004,Rape,01. Rape,53,8,133,0,23,3,141,0,83,67,262,205,160,133,76,0,0,338
Uttar Pradesh,2004,Rape,01. Rape,622,75,1163,14,660,133,1238,0,126,100,4647,4780,1397,1163,1282,0,0,5943
Uttarakhand,2004,Rape,01. Rape,30,9,90,0,41,13,99,0,21,18,189,170,115,90,71,0,0,260
West Bengal,2004,Rape,01. Rape,582,126,1244,0,135,7,1370,0,822,724,6291,5764,1475,1244,717,0,0,7008
Andaman & Nicobar Islands,2005,Rape,01. Rape,3,0,8,0,1,0,8,0,3,7,33,29,4,8,4,0,0,37
Andhra Pradesh,2005,Rape,01. Rape,667,17,933,14,154,70,950,0,528,613,2077,1979,935,933,821,0,0,2912
Arunachal Pradesh,2005,Rape,01. Rape,4,9,32,0,15,0,41,0,16,22,374,361,35,32,19,0,0,393
Assam,2005,Rape,01. Rape,367,163,867,50,170,81,1030,1,1562,1436,2984,2704,1238,867,537,0,0,3571
Bihar,2005,Rape,01. Rape,692,86,823,1,145,129,909,0,1315,1206,3216,3231,1147,823,837,0,0,4054
Chandigarh,2005,Rape,01. Rape,10,0,20,0,4,3,20,0,11,1,54,48,33,20,14,0,0,68
Chhattisgarh,2005,Rape,01. Rape,603,13,919,9,338,5,932,3,119,78,2955,2986,990,919,941,0,9,3905
Dadra & Nagar Haveli,2005,Rape,01. Rape,6,0,6,0,0,0,6,0,2,3,7,7,5,6,6,0,0,13
Daman & Diu,2005,Rape,01. Rape,3,0,0,0,0,0,0,0,2,0,3,6,2,0,3,0,0,6
Delhi,2005,Rape,01. Rape,745,17,570,0,140,3,587,1,268,204,1060,1375,658,570,885,0,3,1945
Goa,2005,Rape,01. Rape,13,4,18,1,7,1,22,0,18,21,47,50,20,18,20,0,0,68
Gujarat,2005,Rape,01. Rape,186,19,286,3,37,4,305,1,40,26,2031,1971,324,286,223,0,0,2257
Haryana,2005,Rape,01. Rape,229,4,375,0,96,61,379,0,43,22,568,518,461,375,325,0,0,893
Himachal Pradesh,2005,Rape,01. Rape,121,2,123,2,24,14,125,0,37,35,378,402,141,123,145,0,0,525
Jammu & Kashmir,2005,Rape,01. Rape,111,7,174,0,5,30,181,0,71,81,789,731,201,174,116,0,0,905
Jharkhand,2005,Rape,01. Rape,411,82,595,12,117,29,677,0,696,649,1968,1913,753,595,528,0,0,2508
Karnataka,2005,Rape,01. Rape,284,7,296,0,87,19,303,5,115,100,991,1066,343,296,371,0,1,1362
Kerala,2005,Rape,01. Rape,286,10,451,4,48,22,461,0,524,529,2809,2696,478,451,334,0,0,3147
Lakshadweep,2005,Rape,01. Rape,0,0,0,0,0,0,0,0,0,0,1,1,0,0,0,0,0,1
Madhya Pradesh,2005,Rape,01. Rape,2005,40,2780,117,702,68,2820,0,188,155,6689,6733,2921,2780,2707,0,0,9513
Maharashtra,2005,Rape,01. Rape,991,28,1441,13,177,17,1469,7,386,334,10208,9948,1545,1441,1168,0,0,11389
Manipur,2005,Rape,01. Rape,1,7,7,0,0,0,14,0,65,54,52,46,25,7,1,0,0,53
Meghalaya,2005,Rape,01. Rape,1,12,37,0,2,1,49,0,133,120,318,284,63,37,3,0,0,321
Mizoram,2005,Rape,01. Rape,5,2,33,5,15,0,35,0,16,14,55,47,37,33,20,0,0,80
Nagaland,2005,Rape,01. Rape,10,8,9,0,15,0,17,0,7,7,30,46,17,9,25,0,0,55
Odisha,2005,Rape,01. Rape,445,8,681,0,114,51,689,1,331,273,2817,2695,799,681,559,0,0,3376
Puducherry,2005,Rape,01. Rape,1,0,6,0,3,0,6,0,5,5,20,18,6,6,4,0,0,24
Punjab,2005,Rape,01. Rape,171,27,328,1,71,41,355,1,140,139,301,216,398,328,242,0,0,544
Rajasthan,2005,Rape,01. Rape,600,5,772,27,227,279,777,0,50,113,1840,1922,993,772,827,0,0,2694
Sikkim,2005,Rape,01. Rape,0,2,13,0,3,0,15,0,8,5,15,5,18,13,3,0,0,18
Tamil Nadu,2005,Rape,01. Rape,469,12,507,14,141,67,519,1,274,290,1338,1455,571,507,610,0,0,1962
Tripura,2005,Rape,01. Rape,86,17,144,0,35,0,161,0,84,83,285,262,162,144,121,0,0,406
Uttar Pradesh,2005,Rape,01. Rape,631,66,1029,28,657,132,1095,0,116,126,4360,4647,1217,1029,1288,0,0,5676
Uttarakhand,2005,Rape,01. Rape,40,8,119,3,21,8,127,0,19,21,244,189,133,119,61,0,0,308
West Bengal,2005,Rape,01. Rape,473,75,1649,0,74,3,1724,0,781,822,7393,6291,1686,1649,547,0,0,7940
Andaman & Nicobar Islands,2006,Rape,01. Rape,2,0,7,0,1,0,7,0,2,3,37,33,6,7,3,0,0,40
Andhra Pradesh,2006,Rape,01. Rape,696,18,821,4,154,79,839,0,659,528,2044,2077,1049,821,850,0,0,2898
Arunachal Pradesh,2006,Rape,01. Rape,1,5,29,1,1,0,34,0,19,16,400,374,37,29,2,0,0,403
Assam,2006,Rape,01. Rape,410,164,794,24,176,91,958,0,1757,1562,3168,2984,1244,794,586,0,0,3778
Bihar,2006,Rape,01. Rape,678,146,772,0,178,150,918,0,1479,1315,3132,3216,1232,772,856,0,0,3988
Chandigarh,2006,Rape,01. Rape,8,1,20,0,9,2,21,0,7,11,57,54,19,20,17,0,0,74
Chhattisgarh,2006,Rape,01. Rape,478,23,994,76,235,3,1017,1,93,119,3160,2955,995,994,713,0,0,3949
Dadra & Nagar Haveli,2006,Rape,01. Rape,4,0,3,0,1,0,3,0,5,2,5,7,6,3,5,0,0,10
Daman & Diu,2006,Rape,01. Rape,2,0,3,0,1,0,3,0,2,2,3,3,3,3,3,0,0,6
Delhi,2006,Rape,01. Rape,456,13,798,0,152,3,811,0,72,268,1250,1060,623,798,608,0,5,1858
Goa,2006,Rape,01. Rape,6,7,14,0,0,0,21,0,18,18,55,47,21,14,6,0,0,61
Gujarat,2006,Rape,01. Rape,157,10,332,4,50,6,342,2,44,40,2152,2031,354,332,207,0,0,2363
Haryana,2006,Rape,01. Rape,241,3,497,0,97,67,500,0,84,43,727,568,608,497,338,0,0,1065
Himachal Pradesh,2006,Rape,01. Rape,75,1,96,1,27,17,97,0,36,37,371,378,113,96,102,0,0,474
Jammu & Kashmir,2006,Rape,01. Rape,108,4,211,2,13,22,215,0,84,71,877,789,250,211,121,0,0,1000
Jharkhand,2006,Rape,01. Rape,654,49,599,2,185,38,648,0,809,696,1726,1968,799,599,839,0,0,2567
Karnataka,2006,Rape,01. Rape,288,12,351,21,51,21,363,5,126,115,982,991,400,351,339,0,0,1342
Kerala,2006,Rape,01. Rape,296,31,495,1,58,20,526,0,578,524,2949,2809,601,495,354,0,1,3304
Lakshadweep,2006,Rape,01. Rape,0,0,0,0,0,0,0,0,0,0,1,1,0,0,0,0,0,1
Madhya Pradesh,2006,Rape,01. Rape,1877,34,2779,13,748,81,2813,0,194,188,6830,6689,2900,2779,2625,0,0,9468
Maharashtra,2006,Rape,01. Rape,884,29,1351,9,163,19,1380,0,487,386,10503,10208,1500,1351,1047,0,0,11559
Manipur,2006,Rape,01. Rape,1,12,2,1,0,0,14,0,91,65,52,52,40,2,1,0,0,54
Meghalaya,2006,Rape,01. Rape,12,21,35,1,2,1,56,0,150,133,338,318,74,35,14,0,0,353
Mizoram,2006,Rape,01. Rape,6,9,69,0,68,0,78,0,10,16,50,55,72,69,74,0,0,124
Nagaland,2006,Rape,01. Rape,1,0,20,1,11,0,20,0,10,7,37,30,23,20,12,0,0,50
Odisha,2006,Rape,01. Rape,365,9,790,0,135,37,799,0,480,331,3107,2817,985,790,500,0,0,3607
Puducherry,2006,Rape,01. Rape,1,0,6,0,1,0,6,0,8,5,24,20,9,6,2,0,0,26
Punjab,2006,Rape,01. Rape,178,29,373,0,90,38,402,1,141,140,406,301,442,373,268,0,0,674
Rajasthan,2006,Rape,01. Rape,499,10,740,16,262,306,750,0,79,50,1803,1840,1085,740,761,0,0,2580
Sikkim,2006,Rape,01. Rape,1,0,16,0,1,0,16,0,12,8,29,15,20,16,2,0,0,31
Tamil Nadu,2006,Rape,01. Rape,358,9,413,4,108,19,422,2,288,274,1281,1338,457,413,466,0,0,1751
Tripura,2006,Rape,01. Rape,52,14,177,0,25,0,191,0,82,84,385,285,189,177,77,0,0,462
Uttar Pradesh,2006,Rape,01. Rape,601,89,1094,8,637,144,1183,0,103,116,4208,4360,1314,1094,1238,0,0,5454
Uttarakhand,2006,Rape,01. Rape,68,12,128,1,29,6,140,0,20,19,274,244,147,128,97,0,0,372
West Bengal,2006,Rape,01. Rape,747,90,1520,0,137,3,1610,1,898,781,8029,7393,1731,1520,884,0,0,8913
Andaman & Nicobar Islands,2007,Rape,01. Rape,2,0,3,0,1,0,3,0,2,2,37,37,3,3,3,0,0,40
Andhra Pradesh,2007,Rape,01. Rape,834,25,1066,3,128,86,1091,1,551,659,2145,2044,1070,1066,962,0,0,3110
Arunachal Pradesh,2007,Rape,01. Rape,2,11,29,0,5,0,40,0,27,19,422,400,48,29,7,0,0,429
Assam,2007,Rape,01. Rape,466,216,904,28,191,109,1120,0,1965,1757,3387,3168,1437,904,657,0,0,4072
Bihar,2007,Rape,01. Rape,659,197,1103,1,167,317,1300,0,1417,1479,3408,3132,1555,1103,826,0,0,4235
Chandigarh,2007,Rape,01. Rape,8,1,19,0,11,0,20,0,9,7,57,57,22,19,19,0,0,76
Chhattisgarh,2007,Rape,01. Rape,506,7,939,4,162,22,946,0,107,93,3427,3160,982,939,668,0,0,4099
Dadra & Nagar Haveli,2007,Rape,01. Rape,2,0,6,0,0,0,6,0,6,5,9,5,7,6,2,0,0,11
Daman & Diu,2007,Rape,01. Rape,2,0,1,0,0,0,1,0,2,2,2,3,1,1,2,0,0,4
Delhi,2007,Rape,01. Rape,426,12,541,0,163,11,553,2,104,72,1202,1250,598,541,589,0,0,1791
Goa,2007,Rape,01. Rape,5,1,15,0,1,0,16,0,22,18,64,55,20,15,6,0,0,70
Gujarat,2007,Rape,01. Rape,150,17,289,3,50,4,306,2,48,44,2238,2152,316,289,200,0,0,2441
Haryana,2007,Rape,01. Rape,260,7,432,0,114,69,439,0,64,84,785,727,488,432,374,0,0,1159
Himachal Pradesh,2007,Rape,01. Rape,69,4,105,3,14,28,109,0,58,36,390,371,159,105,83,0,0,476
Jammu & Kashmir,2007,Rape,01. Rape,129,10,238,0,8,34,248,0,90,84,978,877,288,238,137,0,0,1115
Jharkhand,2007,Rape,01. Rape,535,60,692,8,318,56,752,0,856,809,1557,1726,855,692,853,0,0,2418
Karnataka,2007,Rape,01. Rape,235,20,364,3,59,24,384,7,146,126,1049,982,436,364,294,0,1,1346
Kerala,2007,Rape,01. Rape,448,19,546,5,74,15,565,0,510,578,2968,2949,512,546,522,0,0,3495
Lakshadweep,2007,Rape,01. Rape,0,0,1,0,0,0,1,0,0,0,2,1,1,1,0,0,0,2
Madhya Pradesh,2007,Rape,01. Rape,1950,44,2898,6,688,58,2942,0,204,194,7084,6830,3010,2898,2638,0,0,9728
Maharashtra,2007,Rape,01. Rape,754,47,1404,10,151,16,1451,1,470,487,10992,10503,1451,1404,905,0,0,11907
Manipur,2007,Rape,01. Rape,2,8,2,1,0,0,10,0,101,91,51,52,20,2,2,0,0,54
Meghalaya,2007,Rape,01. Rape,7,10,32,0,8,1,42,0,189,150,355,338,82,32,15,0,0,370
Mizoram,2007,Rape,01. Rape,7,2,78,0,28,0,80,0,13,10,93,50,83,78,35,0,0,128
Nagaland,2007,Rape,01. Rape,2,2,12,1,26,0,14,0,9,10,20,37,13,12,28,0,0,49
Odisha,2007,Rape,01. Rape,434,14,784,2,175,31,798,0,590,480,3280,3107,939,784,609,0,0,3891
Puducherry,2007,Rape,01. Rape,3,0,9,0,4,0,9,0,8,8,26,24,9,9,7,0,0,33
Punjab,2007,Rape,01. Rape,199,29,392,1,76,37,421,0,202,141,522,406,519,392,275,0,0,798
Rajasthan,2007,Rape,01. Rape,403,6,854,15,236,364,860,0,93,79,2003,1803,1238,854,639,0,0,2657
Sikkim,2007,Rape,01. Rape,3,0,19,1,0,0,19,0,17,12,44,29,24,19,3,0,0,48
Tamil Nadu,2007,Rape,01. Rape,311,9,434,6,87,22,443,1,345,288,1311,1281,523,434,398,0,0,1715
Tripura,2007,Rape,01. Rape,126,4,180,0,30,0,184,0,55,82,409,385,157,180,156,0,0,565
Uttar Pradesh,2007,Rape,01. Rape,542,112,1293,6,573,248,1405,0,98,103,4380,4208,1648,1293,1115,0,0,5501
Uttarakhand,2007,Rape,01. Rape,64,9,101,0,48,9,110,0,18,20,263,274,117,101,112,0,0,375
West Bengal,2007,Rape,01. Rape,737,97,1832,0,101,5,1929,0,1070,898,9023,8029,2106,1832,838,0,0,9861
Andaman & Nicobar Islands,2008,Rape,01. Rape,5,0,2,0,0,0,2,0,12,2,34,37,12,2,5,0,0,39
Andhra Pradesh,2008,Rape,01. Rape,712,24,1083,4,100,83,1107,0,617,551,2412,2145,1257,1083,812,0,1,3228
Arunachal Pradesh,2008,Rape,01. Rape,1,19,22,0,1,0,41,0,28,27,442,422,42,22,2,0,0,444
Assam,2008,Rape,01. Rape,494,231,988,20,94,95,1219,0,2089,1965,3767,3387,1438,988,588,0,0,4375
Bihar,2008,Rape,01. Rape,561,192,921,2,168,315,1113,0,1291,1417,3598,3408,1302,921,729,0,0,4329
Chandigarh,2008,Rape,01. Rape,12,1,19,0,5,2,20,0,7,9,59,57,20,19,17,0,0,76
Chhattisgarh,2008,Rape,01. Rape,680,9,922,68,206,9,931,11,134,107,3395,3427,978,922,886,0,0,4349
Dadra & Nagar Haveli,2008,Rape,01. Rape,5,0,7,0,0,0,7,0,5,6,11,9,6,7,5,0,0,16
Daman & Diu,2008,Rape,01. Rape,2,1,0,0,0,0,1,0,1,2,0,2,0,0,2,0,0,2
Delhi,2008,Rape,01. Rape,261,8,478,0,115,14,486,1,69,104,1304,1202,466,478,376,0,0,1680
Goa,2008,Rape,01. Rape,17,2,21,0,6,0,23,0,29,22,62,64,30,21,23,0,0,85
Gujarat,2008,Rape,01. Rape,165,28,328,5,48,10,356,2,54,48,2348,2238,374,328,213,0,0,2566
Haryana,2008,Rape,01. Rape,326,6,508,0,128,92,514,0,89,64,839,785,631,508,454,0,0,1293
Himachal Pradesh,2008,Rape,01. Rape,87,5,115,1,29,19,120,0,76,58,388,390,157,115,116,0,0,505
Jammu & Kashmir,2008,Rape,01. Rape,131,9,142,2,10,48,151,0,110,90,977,978,219,142,141,0,0,1120
Jharkhand,2008,Rape,01. Rape,494,87,768,42,136,47,855,0,745,856,1653,1557,791,768,630,0,0,2325
Karnataka,2008,Rape,01. Rape,291,17,412,4,45,32,429,7,123,146,1121,1049,446,412,336,0,1,1461
Kerala,2008,Rape,01. Rape,247,16,467,1,38,28,483,1,566,510,3149,2968,568,467,285,0,0,3435
Lakshadweep,2008,Rape,01. Rape,0,1,1,0,1,0,2,0,0,0,2,2,2,1,1,0,0,3
Madhya Pradesh,2008,Rape,01. Rape,1892,51,2791,12,839,52,2842,0,247,204,7132,7084,2937,2791,2731,0,0,9875
Maharashtra,2008,Rape,01. Rape,889,24,1449,13,160,23,1473,1,531,470,11379,10992,1558,1449,1049,0,0,12441
Manipur,2008,Rape,01. Rape,0,6,6,0,0,0,12,0,127,101,57,51,38,6,0,0,0,57
Meghalaya,2008,Rape,01. Rape,15,5,41,0,11,0,46,0,231,189,370,355,88,41,26,0,0,396
Mizoram,2008,Rape,01. Rape,7,0,69,0,85,0,69,0,21,13,70,93,77,69,92,0,0,162
Nagaland,2008,Rape,01. Rape,2,3,18,1,13,0,21,0,7,9,22,20,19,18,15,0,0,38
Odisha,2008,Rape,01. Rape,486,18,883,0,159,23,901,1,778,590,3518,3280,1113,883,645,0,0,4163
Puducherry,2008,Rape,01. Rape,2,0,6,0,0,0,6,0,10,8,30,26,8,6,2,0,0,32
Punjab,2008,Rape,01. Rape,290,44,442,2,149,55,486,0,178,202,523,522,517,442,439,0,0,964
Rajasthan,2008,Rape,01. Rape,431,12,857,14,232,460,869,0,119,93,2183,2003,1355,857,663,0,0,2860
Sikkim,2008,Rape,01. Rape,2,0,20,0,5,0,20,0,17,17,57,44,20,20,7,0,0,64
Tamil Nadu,2008,Rape,01. Rape,323,22,466,4,109,26,488,1,403,345,1341,1311,573,466,432,0,0,1777
Tripura,2008,Rape,01. Rape,61,10,185,2,23,1,195,0,63,55,508,409,204,185,84,0,0,594
Uttar Pradesh,2008,Rape,01. Rape,693,117,1405,4,681,339,1522,0,108,98,4407,4380,1871,1405,1374,0,0,5785
Uttarakhand,2008,Rape,01. Rape,68,7,79,0,39,6,86,0,13,18,235,263,87,79,107,0,0,342
West Bengal,2008,Rape,01. Rape,767,177,1693,2,138,6,1870,1,1456,1070,9809,9023,2263,1693,905,0,0,10716
Andaman & Nicobar Islands,2009,Rape,01. Rape,2,3,14,0,1,0,17,0,13,12,45,34,18,14,3,0,0,48
Andhra Pradesh,2009,Rape,01. Rape,849,26,965,4,118,84,991,0,730,617,2406,2412,1188,965,967,0,0,3377
Arunachal Pradesh,2009,Rape,01. Rape,2,12,46,0,3,0,58,0,29,28,483,442,59,46,5,0,0,488
Assam,2009,Rape,01. Rape,371,248,1004,47,128,119,1252,6,2343,2089,4225,3767,1631,1004,499,0,0,4771
Bihar,2009,Rape,01. Rape,560,170,763,2,178,169,933,0,1118,1291,3621,3598,929,763,738,0,0,4361
Chandigarh,2009,Rape,01. Rape,12,1,17,0,16,1,18,0,17,7,48,59,29,17,28,0,0,76
Chhattisgarh,2009,Rape,01. Rape,612,10,982,1,219,23,992,0,95,134,3545,3395,976,982,831,0,0,4377
Dadra & Nagar Haveli,2009,Rape,01. Rape,1,0,4,0,1,0,4,0,5,5,13,11,4,4,2,0,0,15
Daman & Diu,2009,Rape,01. Rape,0,1,1,0,0,0,2,0,0,1,1,0,1,1,0,0,0,1
Delhi,2009,Rape,01. Rape,198,22,440,0,178,8,462,2,65,69,1368,1304,469,440,376,0,1,1744
Goa,2009,Rape,01. Rape,18,4,24,0,7,0,28,0,48,29,61,62,47,24,25,0,0,86
Gujarat,2009,Rape,01. Rape,150,21,377,2,33,5,398,2,82,54,2540,2348,433,377,183,0,0,2725
Haryana,2009,Rape,01. Rape,350,8,525,0,125,70,533,0,89,89,889,839,603,525,475,0,0,1364
Himachal Pradesh,2009,Rape,01. Rape,89,2,176,0,29,25,178,0,56,76,446,388,183,176,118,0,0,564
Jammu & Kashmir,2009,Rape,01. Rape,194,7,196,6,12,52,203,0,84,102,961,977,237,196,206,0,0,1173
Jharkhand,2009,Rape,01. Rape,428,49,687,23,294,46,736,0,682,745,1595,1653,719,687,722,0,0,2340
Karnataka,2009,Rape,01. Rape,309,37,401,10,33,15,438,7,172,123,1170,1121,509,401,342,0,0,1522
Kerala,2009,Rape,01. Rape,283,18,615,1,53,19,633,0,482,566,3427,3149,568,615,336,0,0,3764
Lakshadweep,2009,Rape,01. Rape,0,1,0,0,0,0,1,0,0,0,2,2,1,0,0,0,0,2
Madhya Pradesh,2009,Rape,01. Rape,1716,34,2951,8,562,37,2985,0,223,247,7797,7132,2998,2951,2278,0,0,10083
Maharashtra,2009,Rape,01. Rape,771,41,1433,4,182,25,1474,0,515,531,11855,11379,1483,1433,953,0,0,12812
Manipur,2009,Rape,01. Rape,0,7,5,0,0,0,12,0,146,127,62,57,31,5,0,0,0,62
Meghalaya,2009,Rape,01. Rape,16,27,67,0,7,0,94,0,249,231,414,370,112,67,23,0,0,437
Mizoram,2009,Rape,01. Rape,8,3,86,0,58,0,89,0,15,21,90,70,83,86,66,0,0,156
Nagaland,2009,Rape,01. Rape,1,2,25,0,10,0,27,0,2,7,36,22,22,25,11,0,0,47
Odisha,2009,Rape,01. Rape,527,8,834,0,146,28,842,1,930,778,3679,3518,1023,834,673,0,0,4352
Puducherry,2009,Rape,01. Rape,2,0,8,0,4,1,8,0,2,10,32,30,1,8,6,0,0,38
Punjab,2009,Rape,01. Rape,307,52,440,0,158,49,492,0,148,178,498,523,511,440,465,0,0,963
Rajasthan,2009,Rape,01. Rape,385,13,967,14,221,518,980,0,140,119,2530,2183,1519,967,606,0,0,3150
Sikkim,2009,Rape,01. Rape,12,0,19,1,5,0,19,0,16,17,58,57,18,19,17,0,0,76
Tamil Nadu,2009,Rape,01. Rape,315,20,515,7,91,25,535,0,439,403,1443,1341,596,515,406,0,0,1856
Tripura,2009,Rape,01. Rape,72,10,169,2,24,0,179,0,74,63,579,508,190,169,96,0,0,677
Uttar Pradesh,2009,Rape,01. Rape,730,116,1312,0,623,341,1428,0,98,108,4366,4407,1759,1312,1353,0,0,5719
Uttarakhand,2009,Rape,01. Rape,45,7,98,0,49,15,105,0,4,13,239,235,111,98,94,0,0,333
West Bengal,2009,Rape,01. Rape,731,108,1572,2,130,4,1680,0,2108,1456,10518,9809,2336,1572,861,0,0,11381
Andaman & Nicobar Islands,2010,Rape,01. Rape,0,0,20,0,0,0,20,0,17,13,65,45,24,20,0,0,0,65
Andhra Pradesh,2010,Rape,01. Rape,890,22,1210,6,141,89,1232,3,768,730,2579,2406,1362,1210,1031,0,0,3616
Arunachal Pradesh,2010,Rape,01. Rape,2,6,34,2,4,0,40,0,36,29,509,483,47,34,6,0,0,517
Assam,2010,Rape,01. Rape,431,282,1110,44,95,115,1392,32,2525,2343,4765,4225,1721,1110,526,0,0,5335
Bihar,2010,Rape,01. Rape,646,154,533,0,227,100,687,0,1126,1118,3281,3621,795,533,873,0,0,4154
Chandigarh,2010,Rape,01. Rape,17,1,29,0,14,6,30,0,12,17,46,48,31,29,31,0,0,77
Chhattisgarh,2010,Rape,01. Rape,621,18,942,2,204,16,960,0,131,95,3660,3545,1012,942,825,0,0,4487
Dadra & Nagar Haveli,2010,Rape,01. Rape,2,0,4,0,2,0,4,0,4,5,13,13,3,4,4,0,0,17
Daman & Diu,2010,Rape,01. Rape,0,0,1,0,0,0,1,0,0,0,2,1,1,1,0,0,0,2
Delhi,2010,Rape,01. Rape,266,30,449,0,141,13,479,1,78,65,1410,1368,507,449,407,0,1,1817
Goa,2010,Rape,01. Rape,22,2,44,0,5,2,46,0,36,48,78,61,36,44,27,0,0,105
Gujarat,2010,Rape,01. Rape,154,25,391,2,33,3,416,1,70,82,2742,2540,408,391,187,0,0,2931
Haryana,2010,Rape,01. Rape,343,15,590,0,113,99,605,0,105,89,1023,889,720,590,456,0,0,1479
Himachal Pradesh,2010,Rape,01. Rape,89,3,139,1,21,25,142,0,49,56,474,446,160,139,110,0,0,585
Jammu & Kashmir,2010,Rape,01. Rape,140,1,177,1,3,55,178,0,96,84,994,961,245,177,143,0,0,1138
Jharkhand,2010,Rape,01. Rape,425,69,705,17,171,60,774,0,621,682,1687,1595,773,705,596,0,0,2300
Karnataka,2010,Rape,01. Rape,296,28,512,1,54,16,540,3,199,172,1331,1170,586,512,350,0,0,1682
Kerala,2010,Rape,01. Rape,211,18,644,0,45,18,662,1,435,482,3815,3427,634,644,256,0,0,4071
Lakshadweep,2010,Rape,01. Rape,0,0,0,0,0,0,0,0,0,0,2,2,0,0,0,0,0,2
Madhya Pradesh,2010,Rape,01. Rape,1974,36,3089,27,777,34,3125,0,199,223,8108,7797,3135,3089,2751,0,0,10886
Maharashtra,2010,Rape,01. Rape,902,29,1458,11,146,20,1487,1,606,515,12254,11855,1599,1458,1048,0,0,13313
Manipur,2010,Rape,01. Rape,2,11,4,0,1,0,15,0,165,146,63,62,34,4,3,0,0,66
Meghalaya,2010,Rape,01. Rape,5,11,80,2,4,1,91,0,306,249,483,414,149,80,9,0,0,494
Mizoram,2010,Rape,01. Rape,3,0,94,0,84,0,94,0,13,15,97,90,92,94,87,0,0,184
Nagaland,2010,Rape,01. Rape,5,1,13,0,14,0,14,0,4,2,30,36,16,13,19,0,0,49
Odisha,2010,Rape,01. Rape,534,19,1126,0,132,63,1145,1,746,930,4139,3679,1025,1126,666,0,0,4805
Puducherry,2010,Rape,01. Rape,0,0,2,0,1,0,2,0,3,2,33,32,3,2,1,0,0,34
Punjab,2010,Rape,01. Rape,324,31,438,0,166,62,469,0,208,193,457,509,546,438,490,0,0,947
Rajasthan,2010,Rape,01. Rape,454,11,972,16,202,550,983,0,178,140,2830,2530,1571,972,656,0,0,3502
Sikkim,2010,Rape,01. Rape,1,0,31,0,2,0,31,0,3,16,86,58,18,31,3,0,0,89
Tamil Nadu,2010,Rape,01. Rape,327,38,487,1,105,35,525,0,565,439,1497,1443,686,487,432,0,0,1930
Tripura,2010,Rape,01. Rape,84,8,185,1,28,2,193,0,117,74,651,579,238,185,112,0,0,764
Uttar Pradesh,2010,Rape,01. Rape,687,108,1171,0,705,272,1279,0,110,98,4145,4366,1563,1171,1392,0,0,5537
Uttarakhand,2010,Rape,01. Rape,53,5,104,0,58,11,109,0,5,4,232,239,121,104,111,0,0,343
West Bengal,2010,Rape,01. Rape,565,94,1866,15,90,14,1960,1,2444,2108,11714,10518,2311,1866,655,0,0,12384
Andaman & Nicobar Islands,2001,Kidnapping & Abduction - Women & Girls,02. Kidnapping & Abduction of Women & Girls,2,1,3,0,0,0,4,0,0,2,16,15,2,3,2,0,0,18
Andhra Pradesh,2001,Kidnapping & Abduction - Women & Girls,02. Kidnapping & Abduction of Women & Girls,233,23,454,28,30,206,477,45,322,285,1128,965,765,454,263,0,0,1419
Arunachal Pradesh,2001,Kidnapping & Abduction - Women & Girls,02. Kidnapping & Abduction of Women & Girls,5,9,34,0,4,0,43,0,19,7,233,208,55,34,9,0,0,242
Assam,2001,Kidnapping & Abduction - Women & Girls,02. Kidnapping & Abduction of Women & Girls,307,361,437,29,64,115,798,2,2036,1881,1662,1625,1070,437,371,0,0,2062
Bihar,2001,Kidnapping & Abduction - Women & Girls,02. Kidnapping & Abduction of Women & Girls,221,98,398,3,76,69,496,0,584,631,2920,2822,518,398,297,0,0,3220
Chandigarh,2001,Kidnapping & Abduction - Women & Girls,02. Kidnapping & Abduction of Women & Girls,11,4,19,0,1,25,23,0,12,10,58,51,50,19,12,0,0,70
Chhattisgarh,2001,Kidnapping & Abduction - Women & Girls,02. Kidnapping & Abduction of Women & Girls,51,15,160,2,17,2,175,3,34,43,917,827,171,160,68,0,0,987
Dadra & Nagar Haveli,2001,Kidnapping & Abduction - Women & Girls,02. Kidnapping & Abduction of Women & Girls,0,3,2,0,0,0,5,0,3,6,7,5,2,2,0,0,0,7
Daman & Diu,2001,Kidnapping & Abduction - Women & Girls,02. Kidnapping & Abduction of Women & Girls,2,2,0,0,0,0,2,0,1,0,2,4,3,0,2,0,0,4
Delhi,2001,Kidnapping & Abduction - Women & Girls,02. Kidnapping & Abduction of Women & Girls,757,513,324,0,433,188,837,0,901,962,175,1041,964,324,1190,0,0,1365
Goa,2001,Kidnapping & Abduction - Women & Girls,02. Kidnapping & Abduction of Women & Girls,17,5,1,0,5,0,6,0,5,5,20,41,6,1,22,0,0,42
Gujarat,2001,Kidnapping & Abduction - Women & Girls,02. Kidnapping & Abduction of Women & Girls,251,145,628,18,25,117,773,4,123,160,4410,4076,857,628,276,0,0,4704
Haryana,2001,Kidnapping & Abduction - Women & Girls,02. Kidnapping & Abduction of Women & Girls,138,20,172,0,36,91,192,0,67,53,707,709,297,172,174,0,0,881
Himachal Pradesh,2001,Kidnapping & Abduction - Women & Girls,02. Kidnapping & Abduction of Women & Girls,30,7,35,0,3,68,42,0,32,37,168,166,105,35,33,0,0,201
Jammu & Kashmir,2001,Kidnapping & Abduction - Women & Girls,02. Kidnapping & Abduction of Women & Girls,223,33,364,18,0,148,397,0,247,288,2121,1998,504,364,223,0,0,2362
Jharkhand,2001,Kidnapping & Abduction - Women & Girls,02. Kidnapping & Abduction of Women & Girls,82,54,205,0,33,32,259,0,70,82,1019,929,279,205,115,0,0,1134
Karnataka,2001,Kidnapping & Abduction - Women & Girls,02. Kidnapping & Abduction of Women & Girls,158,44,167,4,8,77,211,2,84,103,690,693,271,167,166,0,0,860
Kerala,2001,Kidnapping & Abduction - Women & Girls,02. Kidnapping & Abduction of Women & Girls,50,11,61,2,3,21,72,9,52,57,365,359,97,61,53,0,0,420
Lakshadweep,2001,Kidnapping & Abduction - Women & Girls,02. Kidnapping & Abduction of Women & Girls,0,0,0,0,0,0,0,0,0,0,0,0,0,0,0,0,0,0
Madhya Pradesh,2001,Kidnapping & Abduction - Women & Girls,02. Kidnapping & Abduction of Women & Girls,119,155,471,115,74,24,626,0,135,130,2767,2631,668,471,193,27,13,3075
Maharashtra,2001,Kidnapping & Abduction - Women & Girls,02. Kidnapping & Abduction of Women & Girls,376,104,496,38,32,96,600,1,153,239,4912,4862,611,496,408,0,0,5358
Manipur,2001,Kidnapping & Abduction - Women & Girls,02. Kidnapping & Abduction of Women & Girls,2,92,1,0,0,0,93,0,54,85,29,30,62,1,2,0,0,31
Meghalaya,2001,Kidnapping & Abduction - Women & Girls,02. Kidnapping & Abduction of Women & Girls,3,5,6,0,0,0,11,0,15,15,78,75,11,6,3,0,0,81
Mizoram,2001,Kidnapping & Abduction - Women & Girls,02. Kidnapping & Abduction of Women & Girls,0,0,1,0,3,0,1,0,0,0,1,3,1,1,3,0,0,4
Nagaland,2001,Kidnapping & Abduction - Women & Girls,02. Kidnapping & Abduction of Women & Girls,0,0,2,0,1,0,2,0,17,13,31,30,6,2,1,0,0,32
Odisha,2001,Kidnapping & Abduction - Women & Girls,02. Kidnapping & Abduction of Women & Girls,260,29,349,0,41,55,378,0,229,228,1323,1275,434,349,301,0,0,1624
Puducherry,2001,Kidnapping & Abduction - Women & Girls,02. Kidnapping & Abduction of Women & Girls,0,0,1,0,1,1,1,1,1,1,9,9,3,1,1,0,0,10
Punjab,2001,Kidnapping & Abduction - Women & Girls,02. Kidnapping & Abduction of Women & Girls,78,70,133,2,19,103,203,1,242,225,459,425,324,133,97,0,0,558
Rajasthan,2001,Kidnapping & Abduction - Women & Girls,02. Kidnapping & Abduction of Women & Girls,510,244,630,27,187,1387,874,0,87,183,4232,4326,2165,630,697,0,0,4956
Sikkim,2001,Kidnapping & Abduction - Women & Girls,02. Kidnapping & Abduction of Women & Girls,0,0,0,0,0,0,0,0,2,0,0,0,2,0,0,0,0,0
Tamil Nadu,2001,Kidnapping & Abduction - Women & Girls,02. Kidnapping & Abduction of Women & Girls,190,82,340,23,60,204,422,58,352,440,979,912,607,340,250,0,11,1252
Tripura,2001,Kidnapping & Abduction - Women & Girls,02. Kidnapping & Abduction of Women & Girls,12,4,13,0,2,0,17,0,32,14,23,24,35,13,14,0,0,37
Uttar Pradesh,2001,Kidnapping & Abduction - Women & Girls,02. Kidnapping & Abduction of Women & Girls,710,694,1863,63,789,273,2557,0,559,510,6707,6406,2879,1863,1499,0,0,8269
Uttarakhand,2001,Kidnapping & Abduction - Women & Girls,02. Kidnapping & Abduction of Women & Girls,44,31,82,5,38,12,113,0,18,17,284,289,126,82,82,0,0,371
West Bengal,2001,Kidnapping & Abduction - Women & Girls,02. Kidnapping & Abduction of Women & Girls,209,227,889,12,18,167,1116,1,1473,2062,4296,3646,695,889,227,0,0,4535
Andaman & Nicobar Islands,2002,Kidnapping & Abduction - Women & Girls,02. Kidnapping & Abduction of Women & Girls,2,0,1,0,0,0,1,0,0,0,15,16,1,1,2,0,0,17
Andhra Pradesh,2002,Kidnapping & Abduction - Women & Girls,02. Kidnapping & Abduction of Women & Girls,375,53,438,22,28,349,491,1,335,322,1141,1128,854,438,403,0,0,1566
Arunachal Pradesh,2002,Kidnapping & Abduction - Women & Girls,02. Kidnapping & Abduction of Women & Girls,0,25,23,0,0,0,48,0,9,19,256,233,38,23,0,0,0,256
Assam,2002,Kidnapping & Abduction - Women & Girls,02. Kidnapping & Abduction of Women & Girls,236,329,557,31,65,108,886,2,2316,2036,1887,1662,1276,557,301,0,0,2219
Bihar,2002,Kidnapping & Abduction - Women & Girls,02. Kidnapping & Abduction of Women & Girls,242,138,447,0,81,113,585,0,630,584,3044,2920,744,447,323,0,0,3367
Chandigarh,2002,Kidnapping & Abduction - Women & Girls,02. Kidnapping & Abduction of Women & Girls,12,6,24,0,4,20,30,0,9,12,66,58,47,24,16,0,0,82
Chhattisgarh,2002,Kidnapping & Abduction - Women & Girls,02. Kidnapping & Abduction of Women & Girls,137,20,138,51,39,3,158,1,27,35,821,910,154,138,176,0,0,1048
Dadra & Nagar Haveli,2002,Kidnapping & Abduction - Women & Girls,02. Kidnapping & Abduction of Women & Girls,1,2,5,0,0,1,7,0,1,4,11,7,5,5,1,0,0,12
Daman & Diu,2002,Kidnapping & Abduction - Women & Girls,02. Kidnapping & Abduction of Women & Girls,2,2,0,0,0,0,2,0,1,1,0,2,2,0,2,0,0,2
Delhi,2002,Kidnapping & Abduction - Women & Girls,02. Kidnapping & Abduction of Women & Girls,51,300,302,0,25,155,602,36,985,901,401,175,893,302,76,0,16,477
Goa,2002,Kidnapping & Abduction - Women & Girls,02. Kidnapping & Abduction of Women & Girls,5,3,3,0,0,0,6,0,4,5,18,20,5,3,5,0,0,23
Gujarat,2002,Kidnapping & Abduction - Women & Girls,02. Kidnapping & Abduction of Women & Girls,246,133,554,10,38,116,687,1,126,123,4670,4410,807,554,284,0,0,4964
Haryana,2002,Kidnapping & Abduction - Women & Girls,02. Kidnapping & Abduction of Women & Girls,185,30,204,1,53,84,234,0,39,67,672,707,290,204,238,0,0,911
Himachal Pradesh,2002,Kidnapping & Abduction - Women & Girls,02. Kidnapping & Abduction of Women & Girls,26,6,56,0,9,57,62,0,29,32,189,168,116,56,35,0,0,224
Jammu & Kashmir,2002,Kidnapping & Abduction - Women & Girls,02. Kidnapping & Abduction of Women & Girls,257,20,388,14,3,122,408,0,313,247,2235,2121,596,388,260,0,0,2509
Jharkhand,2002,Kidnapping & Abduction - Women & Girls,02. Kidnapping & Abduction of Women & Girls,115,23,108,3,26,29,131,0,81,63,778,814,178,108,141,0,0,922
Karnataka,2002,Kidnapping & Abduction - Women & Girls,02. Kidnapping & Abduction of Women & Girls,117,49,156,3,5,68,205,6,105,84,721,690,300,156,122,0,0,846
Kerala,2002,Kidnapping & Abduction - Women & Girls,02. Kidnapping & Abduction of Women & Girls,60,8,57,3,6,25,65,5,48,52,353,365,91,57,66,0,0,422
Lakshadweep,2002,Kidnapping & Abduction - Women & Girls,02. Kidnapping & Abduction of Women & Girls,0,0,0,0,0,0,0,0,0,0,0,0,0,0,0,0,0,0
Madhya Pradesh,2002,Kidnapping & Abduction - Women & Girls,02. Kidnapping & Abduction of Women & Girls,353,78,532,18,96,31,610,0,133,135,2832,2767,639,532,449,0,0,3299
Maharashtra,2002,Kidnapping & Abduction - Women & Girls,02. Kidnapping & Abduction of Women & Girls,533,74,471,27,29,96,545,0,162,153,4794,4912,650,471,562,0,0,5383
Manipur,2002,Kidnapping & Abduction - Women & Girls,02. Kidnapping & Abduction of Women & Girls,0,61,1,0,1,0,62,1,73,54,29,29,82,1,1,0,0,30
Meghalaya,2002,Kidnapping & Abduction - Women & Girls,02. Kidnapping & Abduction of Women & Girls,3,0,8,1,0,0,8,0,17,15,82,78,10,8,3,0,0,86
Mizoram,2002,Kidnapping & Abduction - Women & Girls,02. Kidnapping & Abduction of Women & Girls,0,0,1,0,1,0,1,0,1,0,2,2,2,1,1,0,0,3
Nagaland,2002,Kidnapping & Abduction - Women & Girls,02. Kidnapping & Abduction of Women & Girls,0,0,2,0,0,0,2,0,18,17,33,31,4,2,0,0,1,33
Odisha,2002,Kidnapping & Abduction - Women & Girls,02. Kidnapping & Abduction of Women & Girls,276,33,306,0,39,85,339,0,237,229,1314,1323,432,306,315,0,0,1629
Puducherry,2002,Kidnapping & Abduction - Women & Girls,02. Kidnapping & Abduction of Women & Girls,4,0,3,0,1,1,3,1,2,1,7,9,6,3,5,0,0,12
Punjab,2002,Kidnapping & Abduction - Women & Girls,02. Kidnapping & Abduction of Women & Girls,74,57,149,4,36,100,206,5,285,242,494,459,354,149,110,0,0,608
Rajasthan,2002,Kidnapping & Abduction - Women & Girls,02. Kidnapping & Abduction of Women & Girls,607,207,545,39,190,1212,752,0,142,87,3941,4232,2019,545,797,0,0,4777
Sikkim,2002,Kidnapping & Abduction - Women & Girls,02. Kidnapping & Abduction of Women & Girls,2,1,2,0,0,0,3,0,1,2,0,0,2,2,2,0,0,2
Tamil Nadu,2002,Kidnapping & Abduction - Women & Girls,02. Kidnapping & Abduction of Women & Girls,363,80,357,20,66,300,437,39,283,352,887,979,714,357,429,0,7,1336
Tripura,2002,Kidnapping & Abduction - Women & Girls,02. Kidnapping & Abduction of Women & Girls,10,10,29,0,1,0,39,0,41,32,41,23,48,29,11,0,0,52
Uttar Pradesh,2002,Kidnapping & Abduction - Women & Girls,02. Kidnapping & Abduction of Women & Girls,868,588,1764,34,825,281,2352,0,224,559,6744,6707,2298,1764,1693,0,0,8471
Uttarakhand,2002,Kidnapping & Abduction - Women & Girls,02. Kidnapping & Abduction of Women & Girls,31,38,94,0,52,15,132,0,26,18,295,284,155,94,83,0,0,378
West Bengal,2002,Kidnapping & Abduction - Women & Girls,02. Kidnapping & Abduction of Women & Girls,370,173,1073,10,71,29,1246,1,891,1473,4918,4296,694,1073,441,0,0,5369
Andaman & Nicobar Islands,2003,Kidnapping & Abduction - Women & Girls,02. Kidnapping & Abduction of Women & Girls,0,0,0,0,0,0,0,0,2,0,15,15,2,0,0,0,0,15
Andhra Pradesh,2003,Kidnapping & Abduction - Women & Girls,02. Kidnapping & Abduction of Women & Girls,243,46,543,10,31,298,589,13,366,335,1400,1141,931,543,274,0,0,1684
Arunachal Pradesh,2003,Kidnapping & Abduction - Women & Girls,02. Kidnapping & Abduction of Women & Girls,0,19,23,0,1,0,42,0,18,9,278,256,51,23,1,0,0,279
Assam,2003,Kidnapping & Abduction - Women & Girls,02. Kidnapping & Abduction of Women & Girls,321,454,689,63,102,284,1143,4,2236,2316,2090,1887,1351,689,423,0,0,2576
Bihar,2003,Kidnapping & Abduction - Women & Girls,02. Kidnapping & Abduction of Women & Girls,255,124,420,5,77,76,544,0,684,630,3120,3044,674,420,332,7,0,3457
Chandigarh,2003,Kidnapping & Abduction - Women & Girls,02. Kidnapping & Abduction of Women & Girls,9,3,10,0,2,16,13,0,8,9,65,66,28,10,11,0,0,76
Chhattisgarh,2003,Kidnapping & Abduction - Women & Girls,02. Kidnapping & Abduction of Women & Girls,62,18,105,111,25,5,123,1,44,24,727,820,149,105,87,0,0,925
Dadra & Nagar Haveli,2003,Kidnapping & Abduction - Women & Girls,02. Kidnapping & Abduction of Women & Girls,4,0,2,0,1,0,2,0,3,1,8,11,4,2,5,0,0,13
Daman & Diu,2003,Kidnapping & Abduction - Women & Girls,02. Kidnapping & Abduction of Women & Girls,0,2,0,0,0,0,2,0,0,1,1,1,1,0,0,0,0,1
Delhi,2003,Kidnapping & Abduction - Women & Girls,02. Kidnapping & Abduction of Women & Girls,118,326,201,0,14,216,527,36,1000,985,470,401,797,201,132,0,3,602
Goa,2003,Kidnapping & Abduction - Women & Girls,02. Kidnapping & Abduction of Women & Girls,2,4,7,0,0,0,11,0,6,4,23,18,13,7,2,0,0,25
Gujarat,2003,Kidnapping & Abduction - Women & Girls,02. Kidnapping & Abduction of Women & Girls,388,181,535,9,31,156,716,1,112,126,4777,4670,859,535,419,0,0,5205
Haryana,2003,Kidnapping & Abduction - Women & Girls,02. Kidnapping & Abduction of Women & Girls,189,23,159,1,50,78,182,0,50,39,591,672,271,159,239,0,0,831
Himachal Pradesh,2003,Kidnapping & Abduction - Women & Girls,02. Kidnapping & Abduction of Women & Girls,48,7,38,1,7,49,45,0,31,29,171,189,96,38,55,0,0,227
Jammu & Kashmir,2003,Kidnapping & Abduction - Women & Girls,02. Kidnapping & Abduction of Women & Girls,151,21,480,5,2,131,501,0,296,313,2557,2235,615,480,153,0,0,2715
Jharkhand,2003,Kidnapping & Abduction - Women & Girls,02. Kidnapping & Abduction of Women & Girls,130,39,163,8,36,27,202,0,114,81,767,778,262,163,166,0,0,941
Karnataka,2003,Kidnapping & Abduction - Women & Girls,02. Kidnapping & Abduction of Women & Girls,148,54,152,4,1,59,206,4,80,105,720,721,244,152,149,0,0,873
Kerala,2003,Kidnapping & Abduction - Women & Girls,02. Kidnapping & Abduction of Women & Girls,29,3,55,3,4,9,58,7,76,48,372,353,102,55,33,0,0,408
Lakshadweep,2003,Kidnapping & Abduction - Women & Girls,02. Kidnapping & Abduction of Women & Girls,0,0,0,0,0,0,0,0,0,0,0,0,0,0,0,0,0,0
Madhya Pradesh,2003,Kidnapping & Abduction - Women & Girls,02. Kidnapping & Abduction of Women & Girls,635,90,484,12,158,30,574,0,121,117,2671,2992,608,484,793,0,0,3476
Maharashtra,2003,Kidnapping & Abduction - Women & Girls,02. Kidnapping & Abduction of Women & Girls,377,99,445,21,28,49,544,0,194,162,4813,4794,626,445,405,0,1,5239
Manipur,2003,Kidnapping & Abduction - Women & Girls,02. Kidnapping & Abduction of Women & Girls,1,47,2,0,1,0,49,0,95,73,29,29,71,2,2,0,0,31
Meghalaya,2003,Kidnapping & Abduction - Women & Girls,02. Kidnapping & Abduction of Women & Girls,3,3,1,0,0,0,4,0,23,17,80,82,10,1,3,0,0,83
Mizoram,2003,Kidnapping & Abduction - Women & Girls,02. Kidnapping & Abduction of Women & Girls,0,1,1,0,2,0,2,0,1,1,1,2,2,1,2,0,0,3
Nagaland,2003,Kidnapping & Abduction - Women & Girls,02. Kidnapping & Abduction of Women & Girls,0,1,0,0,2,0,1,0,20,18,31,33,3,0,2,0,0,33
Odisha,2003,Kidnapping & Abduction - Women & Girls,02. Kidnapping & Abduction of Women & Girls,256,45,349,0,52,70,394,0,146,237,1355,1314,373,349,308,0,0,1663
Puducherry,2003,Kidnapping & Abduction - Women & Girls,02. Kidnapping & Abduction of Women & Girls,2,0,3,0,0,1,3,1,10,2,8,7,13,3,2,0,0,10
Punjab,2003,Kidnapping & Abduction - Women & Girls,02. Kidnapping & Abduction of Women & Girls,73,102,164,6,25,156,266,4,154,285,554,494,295,164,98,0,0,658
Rajasthan,2003,Kidnapping & Abduction - Women & Girls,02. Kidnapping & Abduction of Women & Girls,556,191,495,33,188,1049,686,0,157,142,3659,3941,1750,495,744,0,0,4436
Sikkim,2003,Kidnapping & Abduction - Women & Girls,02. Kidnapping & Abduction of Women & Girls,0,0,1,0,1,0,1,0,0,1,0,0,0,1,1,0,0,1
Tamil Nadu,2003,Kidnapping & Abduction - Women & Girls,02. Kidnapping & Abduction of Women & Girls,262,87,296,3,37,207,383,11,312,285,755,761,632,296,299,0,4,1057
Tripura,2003,Kidnapping & Abduction - Women & Girls,02. Kidnapping & Abduction of Women & Girls,14,23,46,0,10,0,69,0,1,41,63,41,29,46,24,0,0,87
Uttar Pradesh,2003,Kidnapping & Abduction - Women & Girls,02. Kidnapping & Abduction of Women & Girls,594,214,1025,37,631,168,1239,2,314,224,6507,6744,1499,1025,1225,0,0,7769
Uttarakhand,2003,Kidnapping & Abduction - Women & Girls,02. Kidnapping & Abduction of Women & Girls,21,37,79,2,20,16,116,0,28,26,331,295,134,79,41,0,0,374
West Bengal,2003,Kidnapping & Abduction - Women & Girls,02. Kidnapping & Abduction of Women & Girls,293,88,594,16,66,62,682,0,948,891,5137,4918,801,594,359,0,0,5512
Andaman & Nicobar Islands,2004,Kidnapping & Abduction - Women & Girls,02. Kidnapping & Abduction of Women & Girls,1,1,3,0,1,0,4,0,1,2,16,15,3,3,2,0,0,18
Andhra Pradesh,2004,Kidnapping & Abduction - Women & Girls,02. Kidnapping & Abduction of Women & Girls,421,57,508,30,50,299,565,19,513,366,1407,1400,1030,508,471,0,0,1908
Arunachal Pradesh,2004,Kidnapping & Abduction - Women & Girls,02. Kidnapping & Abduction of Women & Girls,0,11,25,1,2,0,36,0,23,18,300,278,41,25,2,0,0,303
Assam,2004,Kidnapping & Abduction - Women & Girls,02. Kidnapping & Abduction of Women & Girls,337,542,734,94,95,207,1276,0,2305,2236,2298,2090,1552,734,432,0,0,2824
Bihar,2004,Kidnapping & Abduction - Women & Girls,02. Kidnapping & Abduction of Women & Girls,380,137,444,1,71,99,581,0,1001,684,3112,3120,997,444,451,0,0,3564
Chandigarh,2004,Kidnapping & Abduction - Women & Girls,02. Kidnapping & Abduction of Women & Girls,19,2,31,0,1,12,33,0,6,8,76,65,43,31,20,0,0,96
Chhattisgarh,2004,Kidnapping & Abduction - Women & Girls,02. Kidnapping & Abduction of Women & Girls,172,9,153,103,77,18,162,0,38,44,528,727,174,153,249,0,0,880
Dadra & Nagar Haveli,2004,Kidnapping & Abduction - Women & Girls,02. Kidnapping & Abduction of Women & Girls,4,0,4,0,0,0,4,0,6,3,8,8,7,4,4,0,0,12
Daman & Diu,2004,Kidnapping & Abduction - Women & Girls,02. Kidnapping & Abduction of Women & Girls,0,0,0,0,0,0,0,0,0,0,0,0,0,0,0,0,0,0
Delhi,2004,Kidnapping & Abduction - Women & Girls,02. Kidnapping & Abduction of Women & Girls,114,345,274,0,13,155,619,28,1069,1000,617,470,881,274,127,0,10,744
Goa,2004,Kidnapping & Abduction - Women & Girls,02. Kidnapping & Abduction of Women & Girls,4,5,4,0,1,0,9,0,7,6,22,23,10,4,5,0,0,27
Gujarat,2004,Kidnapping & Abduction - Women & Girls,02. Kidnapping & Abduction of Women & Girls,413,146,611,14,46,121,757,2,137,112,4915,4777,905,611,459,0,0,5388
Haryana,2004,Kidnapping & Abduction - Women & Girls,02. Kidnapping & Abduction of Women & Girls,169,19,178,1,38,85,197,0,60,50,561,591,292,178,207,0,0,769
Himachal Pradesh,2004,Kidnapping & Abduction - Women & Girls,02. Kidnapping & Abduction of Women & Girls,39,3,32,0,4,45,35,0,50,31,160,171,99,32,43,0,0,203
Jammu & Kashmir,2004,Kidnapping & Abduction - Women & Girls,02. Kidnapping & Abduction of Women & Girls,214,35,452,9,5,128,487,0,313,296,2781,2557,632,452,219,0,0,3009
Jharkhand,2004,Kidnapping & Abduction - Women & Girls,02. Kidnapping & Abduction of Women & Girls,130,39,163,8,36,27,202,0,63,114,756,767,178,163,166,0,0,930
Karnataka,2004,Kidnapping & Abduction - Women & Girls,02. Kidnapping & Abduction of Women & Girls,137,41,171,3,9,74,212,0,80,80,742,720,286,171,146,0,0,891
Kerala,2004,Kidnapping & Abduction - Women & Girls,02. Kidnapping & Abduction of Women & Girls,48,13,95,2,3,27,108,9,74,76,414,372,142,95,51,0,0,467
Lakshadweep,2004,Kidnapping & Abduction - Women & Girls,02. Kidnapping & Abduction of Women & Girls,0,0,0,0,0,0,0,0,0,0,0,0,0,0,0,0,0,0
Madhya Pradesh,2004,Kidnapping & Abduction - Women & Girls,02. Kidnapping & Abduction of Women & Girls,431,70,498,24,127,21,568,0,116,121,2587,2671,584,498,558,0,0,3169
Maharashtra,2004,Kidnapping & Abduction - Women & Girls,02. Kidnapping & Abduction of Women & Girls,413,90,579,14,31,72,669,0,239,194,4934,4813,787,579,444,0,1,5392
Manipur,2004,Kidnapping & Abduction - Women & Girls,02. Kidnapping & Abduction of Women & Girls,2,39,1,0,0,0,40,2,124,95,28,29,71,1,2,0,0,30
Meghalaya,2004,Kidnapping & Abduction - Women & Girls,02. Kidnapping & Abduction of Women & Girls,2,3,9,0,0,0,12,0,29,23,87,80,18,9,2,0,0,89
Mizoram,2004,Kidnapping & Abduction - Women & Girls,02. Kidnapping & Abduction of Women & Girls,0,0,0,0,0,0,0,0,1,1,1,1,0,0,0,0,0,1
Nagaland,2004,Kidnapping & Abduction - Women & Girls,02. Kidnapping & Abduction of Women & Girls,0,3,11,0,10,0,14,0,10,20,32,31,4,11,10,0,0,42
Odisha,2004,Kidnapping & Abduction - Women & Girls,02. Kidnapping & Abduction of Women & Girls,279,34,303,0,36,66,337,0,165,146,1343,1355,423,303,315,0,1,1658
Puducherry,2004,Kidnapping & Abduction - Women & Girls,02. Kidnapping & Abduction of Women & Girls,5,0,5,0,1,0,5,3,10,10,7,8,8,5,6,0,0,13
Punjab,2004,Kidnapping & Abduction - Women & Girls,02. Kidnapping & Abduction of Women & Girls,91,48,170,7,73,98,218,1,148,154,553,554,311,170,164,0,0,724
Rajasthan,2004,Kidnapping & Abduction - Women & Girls,02. Kidnapping & Abduction of Women & Girls,467,193,598,24,183,1089,791,0,158,157,3583,3659,1881,598,650,0,0,4257
Sikkim,2004,Kidnapping & Abduction - Women & Girls,02. Kidnapping & Abduction of Women & Girls,0,0,3,0,0,0,3,0,1,0,3,0,4,3,0,0,0,3
Tamil Nadu,2004,Kidnapping & Abduction - Women & Girls,02. Kidnapping & Abduction of Women & Girls,232,99,370,9,40,225,469,9,299,312,844,755,692,370,272,0,2,1125
Tripura,2004,Kidnapping & Abduction - Women & Girls,02. Kidnapping & Abduction of Women & Girls,30,9,15,0,14,3,24,0,28,1,34,63,54,15,44,0,0,78
Uttar Pradesh,2004,Kidnapping & Abduction - Women & Girls,02. Kidnapping & Abduction of Women & Girls,691,443,1526,33,768,242,1969,0,427,314,6541,6507,2324,1526,1459,0,0,8033
Uttarakhand,2004,Kidnapping & Abduction - Women & Girls,02. Kidnapping & Abduction of Women & Girls,14,46,62,2,21,15,108,0,32,28,356,331,127,62,35,0,0,393
West Bengal,2004,Kidnapping & Abduction - Women & Girls,02. Kidnapping & Abduction of Women & Girls,331,193,633,11,28,49,826,1,1090,948,5400,5137,1018,633,359,0,0,5770
Andaman & Nicobar Islands,2005,Kidnapping & Abduction - Women & Girls,02. Kidnapping & Abduction of Women & Girls,0,0,0,0,0,0,0,0,2,1,16,16,1,0,0,0,0,16
Andhra Pradesh,2005,Kidnapping & Abduction - Women & Girls,02. Kidnapping & Abduction of Women & Girls,362,65,655,14,55,327,720,0,461,513,1631,1407,995,655,417,0,0,2062
Arunachal Pradesh,2005,Kidnapping & Abduction - Women & Girls,02. Kidnapping & Abduction of Women & Girls,6,13,29,7,6,0,42,0,20,23,310,300,39,29,12,0,0,329
Assam,2005,Kidnapping & Abduction - Women & Girls,02. Kidnapping & Abduction of Women & Girls,351,409,726,138,113,160,1135,0,2466,2305,2422,2298,1456,726,464,0,0,3024
Bihar,2005,Kidnapping & Abduction - Women & Girls,02. Kidnapping & Abduction of Women & Girls,370,93,512,3,71,105,605,0,1220,1001,3180,3112,929,512,441,0,0,3624
Chandigarh,2005,Kidnapping & Abduction - Women & Girls,02. Kidnapping & Abduction of Women & Girls,13,5,12,0,0,19,17,0,15,6,75,76,45,12,13,0,0,88
Chhattisgarh,2005,Kidnapping & Abduction - Women & Girls,02. Kidnapping & Abduction of Women & Girls,51,18,157,0,23,1,175,1,42,38,611,528,184,157,74,0,3,685
Dadra & Nagar Haveli,2005,Kidnapping & Abduction - Women & Girls,02. Kidnapping & Abduction of Women & Girls,5,0,3,0,0,4,3,0,8,6,6,8,9,3,5,0,0,11
Daman & Diu,2005,Kidnapping & Abduction - Women & Girls,02. Kidnapping & Abduction of Women & Girls,0,0,1,0,0,0,1,0,1,0,1,0,2,1,0,0,0,1
Delhi,2005,Kidnapping & Abduction - Women & Girls,02. Kidnapping & Abduction of Women & Girls,51,311,279,0,15,170,590,15,1378,1069,830,617,1106,279,66,0,22,896
Goa,2005,Kidnapping & Abduction - Women & Girls,02. Kidnapping & Abduction of Women & Girls,3,2,6,0,0,0,8,0,11,7,25,22,12,6,3,0,0,28
Gujarat,2005,Kidnapping & Abduction - Women & Girls,02. Kidnapping & Abduction of Women & Girls,316,177,604,18,51,87,781,0,185,137,5134,4915,916,604,367,0,0,5519
Haryana,2005,Kidnapping & Abduction - Women & Girls,02. Kidnapping & Abduction of Women & Girls,94,17,164,0,49,116,181,0,107,60,582,561,344,164,143,0,0,725
Himachal Pradesh,2005,Kidnapping & Abduction - Women & Girls,02. Kidnapping & Abduction of Women & Girls,52,5,49,0,2,57,54,0,41,50,155,160,102,49,54,0,0,209
Jammu & Kashmir,2005,Kidnapping & Abduction - Women & Girls,02. Kidnapping & Abduction of Women & Girls,212,19,455,0,7,115,474,0,382,313,3017,2781,658,455,219,0,0,3236
Jharkhand,2005,Kidnapping & Abduction - Women & Girls,02. Kidnapping & Abduction of Women & Girls,81,44,160,9,13,17,204,0,125,63,813,756,283,160,94,0,0,916
Karnataka,2005,Kidnapping & Abduction - Women & Girls,02. Kidnapping & Abduction of Women & Girls,208,36,151,0,11,71,187,2,132,80,674,742,312,151,219,0,0,893
Kerala,2005,Kidnapping & Abduction - Women & Girls,02. Kidnapping & Abduction of Women & Girls,48,9,94,0,4,19,103,0,81,74,456,414,129,94,52,0,0,508
Lakshadweep,2005,Kidnapping & Abduction - Women & Girls,02. Kidnapping & Abduction of Women & Girls,0,0,0,0,0,0,0,0,0,0,0,0,0,0,0,0,0,0
Madhya Pradesh,2005,Kidnapping & Abduction - Women & Girls,02. Kidnapping & Abduction of Women & Girls,566,86,486,113,177,24,572,0,124,116,2217,2587,604,486,743,0,0,3073
Maharashtra,2005,Kidnapping & Abduction - Women & Girls,02. Kidnapping & Abduction of Women & Girls,381,111,571,10,34,64,682,2,342,239,5080,4934,851,571,415,0,0,5505
Manipur,2005,Kidnapping & Abduction - Women & Girls,02. Kidnapping & Abduction of Women & Girls,3,48,2,0,0,0,50,1,142,124,27,28,69,2,3,0,0,30
Meghalaya,2005,Kidnapping & Abduction - Women & Girls,02. Kidnapping & Abduction of Women & Girls,3,4,3,0,0,0,7,0,41,29,87,87,19,3,3,0,0,90
Mizoram,2005,Kidnapping & Abduction - Women & Girls,02. Kidnapping & Abduction of Women & Girls,0,0,1,1,0,0,1,0,0,1,1,1,0,1,0,0,0,2
Nagaland,2005,Kidnapping & Abduction - Women & Girls,02. Kidnapping & Abduction of Women & Girls,20,7,10,0,18,0,17,0,2,10,4,32,9,10,38,0,0,42
Odisha,2005,Kidnapping & Abduction - Women & Girls,02. Kidnapping & Abduction of Women & Girls,198,24,324,0,23,87,348,0,277,165,1446,1343,547,324,221,0,0,1667
Puducherry,2005,Kidnapping & Abduction - Women & Girls,02. Kidnapping & Abduction of Women & Girls,1,0,6,0,1,1,6,0,6,10,11,7,3,6,2,0,0,13
Punjab,2005,Kidnapping & Abduction - Women & Girls,02. Kidnapping & Abduction of Women & Girls,70,44,163,1,17,92,207,0,178,148,628,553,329,163,87,0,0,716
Rajasthan,2005,Kidnapping & Abduction - Women & Girls,02. Kidnapping & Abduction of Women & Girls,368,220,494,35,155,884,714,0,109,158,3519,3583,1549,494,523,0,0,4077
Sikkim,2005,Kidnapping & Abduction - Women & Girls,02. Kidnapping & Abduction of Women & Girls,0,0,2,0,0,0,2,0,1,1,5,3,2,2,0,0,0,5
Tamil Nadu,2005,Kidnapping & Abduction - Women & Girls,02. Kidnapping & Abduction of Women & Girls,297,153,347,6,73,253,500,19,310,299,813,844,783,347,370,2,0,1189
Tripura,2005,Kidnapping & Abduction - Women & Girls,02. Kidnapping & Abduction of Women & Girls,35,23,37,0,8,0,60,0,11,28,28,34,43,37,43,0,0,71
Uttar Pradesh,2005,Kidnapping & Abduction - Women & Girls,02. Kidnapping & Abduction of Women & Girls,643,424,1538,69,721,218,1962,0,503,427,6646,6541,2256,1538,1364,0,0,8079
Uttarakhand,2005,Kidnapping & Abduction - Women & Girls,02. Kidnapping & Abduction of Women & Girls,38,36,65,1,39,17,101,0,39,32,343,356,125,65,77,0,0,421
West Bengal,2005,Kidnapping & Abduction - Women & Girls,02. Kidnapping & Abduction of Women & Girls,320,176,799,13,66,24,975,0,1130,1090,5800,5400,1039,799,386,0,0,6199
Andaman & Nicobar Islands,2006,Kidnapping & Abduction - Women & Girls,02. Kidnapping & Abduction of Women & Girls,0,0,7,0,0,0,7,0,0,2,23,16,5,7,0,0,0,23
Andhra Pradesh,2006,Kidnapping & Abduction - Women & Girls,02. Kidnapping & Abduction of Women & Girls,436,42,709,47,71,391,751,0,648,461,1786,1631,1329,709,507,0,0,2340
Arunachal Pradesh,2006,Kidnapping & Abduction - Women & Girls,02. Kidnapping & Abduction of Women & Girls,5,10,37,3,3,0,47,0,24,20,336,310,51,37,8,0,0,347
Assam,2006,Kidnapping & Abduction - Women & Girls,02. Kidnapping & Abduction of Women & Girls,527,471,798,92,102,181,1269,0,2560,2466,2499,2422,1544,798,629,0,0,3220
Bihar,2006,Kidnapping & Abduction - Women & Girls,02. Kidnapping & Abduction of Women & Girls,461,270,643,4,118,217,913,0,1174,1220,3240,3180,1084,643,579,0,0,3823
Chandigarh,2006,Kidnapping & Abduction - Women & Girls,02. Kidnapping & Abduction of Women & Girls,24,4,27,0,5,24,31,0,17,15,73,75,57,27,29,0,0,102
Chhattisgarh,2006,Kidnapping & Abduction - Women & Girls,02. Kidnapping & Abduction of Women & Girls,76,17,156,8,45,4,173,1,42,42,638,611,178,156,121,0,0,767
Dadra & Nagar Haveli,2006,Kidnapping & Abduction - Women & Girls,02. Kidnapping & Abduction of Women & Girls,1,2,9,0,0,4,11,0,7,8,14,6,14,9,1,0,0,15
Daman & Diu,2006,Kidnapping & Abduction - Women & Girls,02. Kidnapping & Abduction of Women & Girls,1,0,1,0,0,0,1,0,1,1,1,1,1,1,1,0,0,2
Delhi,2006,Kidnapping & Abduction - Women & Girls,02. Kidnapping & Abduction of Women & Girls,71,251,247,0,40,155,498,17,1751,1378,966,830,1066,247,111,0,23,1077
Goa,2006,Kidnapping & Abduction - Women & Girls,02. Kidnapping & Abduction of Women & Girls,2,3,10,0,0,1,13,0,7,11,33,25,10,10,2,0,0,35
Gujarat,2006,Kidnapping & Abduction - Women & Girls,02. Kidnapping & Abduction of Women & Girls,385,143,654,22,76,100,797,6,227,185,5305,5134,945,654,461,0,0,5788
Haryana,2006,Kidnapping & Abduction - Women & Girls,02. Kidnapping & Abduction of Women & Girls,131,25,263,0,55,139,288,0,111,107,659,582,431,263,186,0,0,845
Himachal Pradesh,2006,Kidnapping & Abduction - Women & Girls,02. Kidnapping & Abduction of Women & Girls,32,7,45,4,6,53,52,0,45,41,158,155,109,45,38,0,0,200
Jammu & Kashmir,2006,Kidnapping & Abduction - Women & Girls,02. Kidnapping & Abduction of Women & Girls,206,16,571,9,8,146,587,0,372,382,3365,3017,723,571,214,0,0,3588
Jharkhand,2006,Kidnapping & Abduction - Women & Girls,02. Kidnapping & Abduction of Women & Girls,133,59,250,3,25,34,309,0,192,125,902,813,410,250,158,0,0,1063
Karnataka,2006,Kidnapping & Abduction - Women & Girls,02. Kidnapping & Abduction of Women & Girls,144,43,198,1,8,84,241,5,129,132,719,674,328,198,152,0,1,872
Kerala,2006,Kidnapping & Abduction - Women & Girls,02. Kidnapping & Abduction of Women & Girls,66,7,149,3,4,16,156,0,111,81,532,456,202,149,70,0,0,605
Lakshadweep,2006,Kidnapping & Abduction - Women & Girls,02. Kidnapping & Abduction of Women & Girls,0,0,0,0,0,0,0,0,0,0,0,0,0,0,0,0,0,0
Madhya Pradesh,2006,Kidnapping & Abduction - Women & Girls,02. Kidnapping & Abduction of Women & Girls,420,72,515,2,215,14,587,0,140,124,2095,2217,617,515,635,0,0,2732
Maharashtra,2006,Kidnapping & Abduction - Women & Girls,02. Kidnapping & Abduction of Women & Girls,298,126,609,14,36,84,735,0,444,342,5341,5080,921,609,334,0,0,5689
Manipur,2006,Kidnapping & Abduction - Women & Girls,02. Kidnapping & Abduction of Women & Girls,0,63,0,0,1,0,63,0,158,142,26,27,79,0,1,0,0,27
Meghalaya,2006,Kidnapping & Abduction - Women & Girls,02. Kidnapping & Abduction of Women & Girls,3,6,10,1,0,0,16,0,50,41,93,87,25,10,3,0,0,97
Mizoram,2006,Kidnapping & Abduction - Women & Girls,02. Kidnapping & Abduction of Women & Girls,0,0,1,0,2,0,1,0,0,0,0,1,1,1,2,0,0,2
Nagaland,2006,Kidnapping & Abduction - Women & Girls,02. Kidnapping & Abduction of Women & Girls,0,0,3,0,2,0,3,0,2,2,5,4,3,3,2,0,0,7
Odisha,2006,Kidnapping & Abduction - Women & Girls,02. Kidnapping & Abduction of Women & Girls,233,26,396,0,46,91,422,1,340,277,1563,1446,577,396,279,0,0,1842
Puducherry,2006,Kidnapping & Abduction - Women & Girls,02. Kidnapping & Abduction of Women & Girls,2,0,8,0,0,1,8,1,9,6,17,11,13,8,2,0,0,19
Punjab,2006,Kidnapping & Abduction - Women & Girls,02. Kidnapping & Abduction of Women & Girls,76,58,162,0,19,103,220,0,273,178,695,628,418,162,95,0,0,790
Rajasthan,2006,Kidnapping & Abduction - Women & Girls,02. Kidnapping & Abduction of Women & Girls,352,161,546,24,225,859,707,0,96,109,3464,3519,1553,546,577,0,0,4065
Sikkim,2006,Kidnapping & Abduction - Women & Girls,02. Kidnapping & Abduction of Women & Girls,0,1,4,0,0,0,5,0,3,1,9,5,7,4,0,0,0,9
Tamil Nadu,2006,Kidnapping & Abduction - Women & Girls,02. Kidnapping & Abduction of Women & Girls,307,100,350,11,58,195,450,10,359,310,787,813,718,350,365,0,14,1163
Tripura,2006,Kidnapping & Abduction - Women & Girls,02. Kidnapping & Abduction of Women & Girls,12,22,27,0,8,0,49,0,24,11,35,28,62,27,20,0,0,55
Uttar Pradesh,2006,Kidnapping & Abduction - Women & Girls,02. Kidnapping & Abduction of Women & Girls,839,577,1815,66,903,257,2392,0,405,503,6653,6646,2551,1815,1742,0,0,8461
Uttarakhand,2006,Kidnapping & Abduction - Women & Girls,02. Kidnapping & Abduction of Women & Girls,41,42,133,27,49,17,175,0,30,39,359,343,183,133,90,0,0,476
West Bengal,2006,Kidnapping & Abduction - Women & Girls,02. Kidnapping & Abduction of Women & Girls,626,233,838,19,120,24,1071,0,1234,1130,5873,5800,1199,838,746,0,0,6638
Andaman & Nicobar Islands,2007,Kidnapping & Abduction - Women & Girls,02. Kidnapping & Abduction of Women & Girls,2,0,3,0,0,0,3,0,6,0,24,23,9,3,2,0,0,26
Andhra Pradesh,2007,Kidnapping & Abduction - Women & Girls,02. Kidnapping & Abduction of Women & Girls,496,47,1003,84,60,495,1050,0,667,648,2149,1786,1564,1003,556,0,0,2789
Arunachal Pradesh,2007,Kidnapping & Abduction - Women & Girls,02. Kidnapping & Abduction of Women & Girls,1,13,33,2,4,0,46,0,22,24,362,336,44,33,5,0,0,369
Assam,2007,Kidnapping & Abduction - Women & Girls,02. Kidnapping & Abduction of Women & Girls,575,413,886,82,250,167,1299,0,2565,2560,2478,2499,1471,886,825,0,0,3385
Bihar,2007,Kidnapping & Abduction - Women & Girls,02. Kidnapping & Abduction of Women & Girls,598,213,787,8,78,248,1000,0,1186,1174,3343,3240,1260,787,676,0,0,4027
Chandigarh,2007,Kidnapping & Abduction - Women & Girls,02. Kidnapping & Abduction of Women & Girls,16,1,23,0,10,14,24,0,25,17,70,73,46,23,26,0,0,96
Chhattisgarh,2007,Kidnapping & Abduction - Women & Girls,02. Kidnapping & Abduction of Women & Girls,51,16,148,1,16,7,164,0,52,42,718,638,181,148,67,0,0,786
Dadra & Nagar Haveli,2007,Kidnapping & Abduction - Women & Girls,02. Kidnapping & Abduction of Women & Girls,3,2,5,0,0,1,7,0,5,7,16,14,6,5,3,0,0,19
Daman & Diu,2007,Kidnapping & Abduction - Women & Girls,02. Kidnapping & Abduction of Women & Girls,0,0,1,0,0,0,1,0,1,1,2,1,1,1,0,0,0,2
Delhi,2007,Kidnapping & Abduction - Women & Girls,02. Kidnapping & Abduction of Women & Girls,68,314,277,0,38,198,591,28,2082,1751,1137,966,1167,277,106,0,19,1243
Goa,2007,Kidnapping & Abduction - Women & Girls,02. Kidnapping & Abduction of Women & Girls,2,3,2,0,2,0,5,0,9,7,31,33,7,2,4,0,0,35
Gujarat,2007,Kidnapping & Abduction - Women & Girls,02. Kidnapping & Abduction of Women & Girls,277,182,789,6,55,95,971,6,244,227,5756,5305,1089,789,332,0,0,6094
Haryana,2007,Kidnapping & Abduction - Women & Girls,02. Kidnapping & Abduction of Women & Girls,170,25,311,1,50,170,336,0,159,111,749,659,554,311,220,0,0,970
Himachal Pradesh,2007,Kidnapping & Abduction - Women & Girls,02. Kidnapping & Abduction of Women & Girls,34,8,51,5,3,71,59,0,65,45,167,158,150,51,37,0,0,209
Jammu & Kashmir,2007,Kidnapping & Abduction - Women & Girls,02. Kidnapping & Abduction of Women & Girls,278,41,496,2,2,197,537,0,345,372,3579,3365,707,496,280,0,0,3861
Jharkhand,2007,Kidnapping & Abduction - Women & Girls,02. Kidnapping & Abduction of Women & Girls,298,74,339,3,125,23,413,0,290,192,815,902,534,339,423,0,0,1241
Karnataka,2007,Kidnapping & Abduction - Women & Girls,02. Kidnapping & Abduction of Women & Girls,138,79,194,0,13,92,273,10,143,129,762,719,390,194,151,0,1,913
Kerala,2007,Kidnapping & Abduction - Women & Girls,02. Kidnapping & Abduction of Women & Girls,56,8,147,3,9,12,155,0,121,111,611,532,177,147,65,0,0,679
Lakshadweep,2007,Kidnapping & Abduction - Women & Girls,02. Kidnapping & Abduction of Women & Girls,0,0,0,0,0,0,0,0,0,0,0,0,0,0,0,0,0,0
Madhya Pradesh,2007,Kidnapping & Abduction - Women & Girls,02. Kidnapping & Abduction of Women & Girls,450,89,585,47,146,20,674,0,147,140,2037,2095,701,585,596,0,0,2680
Maharashtra,2007,Kidnapping & Abduction - Women & Girls,02. Kidnapping & Abduction of Women & Girls,292,121,676,15,53,96,797,0,518,444,5657,5341,967,676,345,0,0,6017
Manipur,2007,Kidnapping & Abduction - Women & Girls,02. Kidnapping & Abduction of Women & Girls,4,48,1,0,1,0,49,0,192,158,22,26,83,1,5,0,0,27
Meghalaya,2007,Kidnapping & Abduction - Women & Girls,02. Kidnapping & Abduction of Women & Girls,1,4,3,0,4,0,7,0,65,50,91,93,22,3,5,0,0,96
Mizoram,2007,Kidnapping & Abduction - Women & Girls,02. Kidnapping & Abduction of Women & Girls,0,0,0,0,0,0,0,0,0,0,0,0,0,0,0,0,0,0
Nagaland,2007,Kidnapping & Abduction - Women & Girls,02. Kidnapping & Abduction of Women & Girls,0,0,3,0,2,0,3,0,5,2,6,5,6,3,2,0,0,8
Odisha,2007,Kidnapping & Abduction - Women & Girls,02. Kidnapping & Abduction of Women & Girls,173,35,402,1,28,59,437,0,504,340,1763,1563,660,402,201,0,0,1965
Puducherry,2007,Kidnapping & Abduction - Women & Girls,02. Kidnapping & Abduction of Women & Girls,4,1,9,0,1,3,10,4,6,9,21,17,14,9,5,0,0,26
Punjab,2007,Kidnapping & Abduction - Women & Girls,02. Kidnapping & Abduction of Women & Girls,77,121,210,3,26,151,331,0,336,273,799,695,545,210,103,0,0,905
Rajasthan,2007,Kidnapping & Abduction - Women & Girls,02. Kidnapping & Abduction of Women & Girls,328,160,556,19,132,962,716,0,112,96,3541,3464,1694,556,460,0,0,4020
Sikkim,2007,Kidnapping & Abduction - Women & Girls,02. Kidnapping & Abduction of Women & Girls,0,0,2,0,0,0,2,0,10,3,11,9,9,2,0,0,0,11
Tamil Nadu,2007,Kidnapping & Abduction - Women & Girls,02. Kidnapping & Abduction of Women & Girls,326,157,453,1,53,253,610,30,558,359,860,787,1097,453,379,0,5,1240
Tripura,2007,Kidnapping & Abduction - Women & Girls,02. Kidnapping & Abduction of Women & Girls,4,11,66,0,5,0,77,0,28,24,92,35,81,66,9,0,0,101
Uttar Pradesh,2007,Kidnapping & Abduction - Women & Girls,02. Kidnapping & Abduction of Women & Girls,860,879,1948,61,804,415,2827,0,526,405,6876,6653,3363,1948,1664,0,0,8601
Uttarakhand,2007,Kidnapping & Abduction - Women & Girls,02. Kidnapping & Abduction of Women & Girls,31,55,120,0,37,39,175,0,43,30,411,359,227,120,68,0,0,479
West Bengal,2007,Kidnapping & Abduction - Women & Girls,02. Kidnapping & Abduction of Women & Girls,422,310,931,15,31,29,1241,0,1554,1234,6336,5873,1590,931,453,0,0,6804
Andaman & Nicobar Islands,2008,Kidnapping & Abduction - Women & Girls,02. Kidnapping & Abduction of Women & Girls,1,4,7,0,0,0,11,0,8,6,30,24,13,7,1,0,0,31
Andhra Pradesh,2008,Kidnapping & Abduction - Women & Girls,02. Kidnapping & Abduction of Women & Girls,573,122,925,71,37,470,1047,0,546,667,2393,2149,1396,925,610,0,0,3074
Arunachal Pradesh,2008,Kidnapping & Abduction - Women & Girls,02. Kidnapping & Abduction of Women & Girls,4,12,26,1,4,0,38,0,31,22,379,362,47,26,8,0,0,388
Assam,2008,Kidnapping & Abduction - Women & Girls,02. Kidnapping & Abduction of Women & Girls,378,531,780,35,89,194,1311,0,2849,2565,2756,2478,1789,780,467,0,0,3258
Bihar,2008,Kidnapping & Abduction - Women & Girls,02. Kidnapping & Abduction of Women & Girls,475,371,837,5,138,317,1208,0,1450,1186,3562,3343,1789,837,613,0,0,4180
Chandigarh,2008,Kidnapping & Abduction - Women & Girls,02. Kidnapping & Abduction of Women & Girls,22,19,13,0,8,4,32,0,31,25,53,70,42,13,30,0,0,83
Chhattisgarh,2008,Kidnapping & Abduction - Women & Girls,02. Kidnapping & Abduction of Women & Girls,91,20,178,145,23,6,198,0,64,52,637,718,216,178,114,0,0,896
Dadra & Nagar Haveli,2008,Kidnapping & Abduction - Women & Girls,02. Kidnapping & Abduction of Women & Girls,1,0,6,0,0,0,6,0,10,5,21,16,11,6,1,0,0,22
Daman & Diu,2008,Kidnapping & Abduction - Women & Girls,02. Kidnapping & Abduction of Women & Girls,0,0,0,0,0,0,0,0,2,1,2,2,1,0,0,0,0,2
Delhi,2008,Kidnapping & Abduction - Women & Girls,02. Kidnapping & Abduction of Women & Girls,127,540,405,0,27,278,945,33,1941,2082,1388,1137,1136,405,154,0,21,1542
Goa,2008,Kidnapping & Abduction - Women & Girls,02. Kidnapping & Abduction of Women & Girls,5,3,8,0,1,0,11,0,26,9,33,31,28,8,6,0,0,39
Gujarat,2008,Kidnapping & Abduction - Women & Girls,02. Kidnapping & Abduction of Women & Girls,322,202,764,9,44,96,966,5,295,244,6145,5756,1119,764,366,0,1,6520
Haryana,2008,Kidnapping & Abduction - Women & Girls,02. Kidnapping & Abduction of Women & Girls,171,40,327,1,71,253,367,0,183,159,833,749,644,327,242,0,0,1076
Himachal Pradesh,2008,Kidnapping & Abduction - Women & Girls,02. Kidnapping & Abduction of Women & Girls,31,6,67,1,10,74,73,0,55,65,192,167,137,67,41,0,0,234
Jammu & Kashmir,2008,Kidnapping & Abduction - Women & Girls,02. Kidnapping & Abduction of Women & Girls,242,14,267,13,1,223,281,0,497,345,3590,3579,656,267,243,0,0,3846
Jharkhand,2008,Kidnapping & Abduction - Women & Girls,02. Kidnapping & Abduction of Women & Girls,237,97,318,17,57,39,415,3,332,290,822,815,499,318,294,0,0,1133
Karnataka,2008,Kidnapping & Abduction - Women & Girls,02. Kidnapping & Abduction of Women & Girls,197,67,201,4,6,83,268,10,187,143,756,762,405,201,203,0,0,963
Kerala,2008,Kidnapping & Abduction - Women & Girls,02. Kidnapping & Abduction of Women & Girls,105,21,155,0,1,23,176,0,88,121,660,611,166,155,106,0,0,766
Lakshadweep,2008,Kidnapping & Abduction - Women & Girls,02. Kidnapping & Abduction of Women & Girls,0,0,0,0,0,0,0,0,1,0,0,0,1,0,0,0,0,0
Madhya Pradesh,2008,Kidnapping & Abduction - Women & Girls,02. Kidnapping & Abduction of Women & Girls,454,59,619,6,204,15,678,0,190,147,1992,2037,736,619,658,0,0,2656
Maharashtra,2008,Kidnapping & Abduction - Women & Girls,02. Kidnapping & Abduction of Women & Girls,404,140,723,27,47,88,863,0,565,518,5902,5657,998,723,451,0,0,6380
Manipur,2008,Kidnapping & Abduction - Women & Girls,02. Kidnapping & Abduction of Women & Girls,0,25,0,0,0,0,25,0,254,192,22,22,87,0,0,0,0,22
Meghalaya,2008,Kidnapping & Abduction - Women & Girls,02. Kidnapping & Abduction of Women & Girls,4,5,3,0,0,0,8,0,82,65,90,91,25,3,4,0,0,94
Mizoram,2008,Kidnapping & Abduction - Women & Girls,02. Kidnapping & Abduction of Women & Girls,0,0,1,0,0,0,1,0,0,0,1,0,1,1,0,0,0,1
Nagaland,2008,Kidnapping & Abduction - Women & Girls,02. Kidnapping & Abduction of Women & Girls,0,2,4,0,5,0,6,0,6,5,5,6,7,4,5,0,0,10
Odisha,2008,Kidnapping & Abduction - Women & Girls,02. Kidnapping & Abduction of Women & Girls,282,25,504,0,67,60,529,0,677,504,1918,1763,762,504,349,0,0,2267
Puducherry,2008,Kidnapping & Abduction - Women & Girls,02. Kidnapping & Abduction of Women & Girls,4,0,5,0,0,0,5,0,10,6,22,21,9,5,4,0,0,26
Punjab,2008,Kidnapping & Abduction - Women & Girls,02. Kidnapping & Abduction of Women & Girls,88,92,257,1,22,172,349,0,329,336,945,799,514,257,110,0,0,1056
Rajasthan,2008,Kidnapping & Abduction - Women & Girls,02. Kidnapping & Abduction of Women & Girls,275,194,612,13,121,995,806,0,174,112,3744,3541,1863,612,396,0,0,4153
Sikkim,2008,Kidnapping & Abduction - Women & Girls,02. Kidnapping & Abduction of Women & Girls,1,1,5,0,1,0,6,0,8,10,14,11,4,5,2,0,0,16
Tamil Nadu,2008,Kidnapping & Abduction - Women & Girls,02. Kidnapping & Abduction of Women & Girls,349,258,521,6,138,301,779,0,637,558,888,860,1160,521,487,0,1,1381
Tripura,2008,Kidnapping & Abduction - Women & Girls,02. Kidnapping & Abduction of Women & Girls,26,23,87,4,4,0,110,0,28,28,145,92,110,87,30,0,0,179
Uttar Pradesh,2008,Kidnapping & Abduction - Women & Girls,02. Kidnapping & Abduction of Women & Girls,1046,1185,2571,22,1172,624,3756,0,585,526,7207,6876,4439,2571,2218,0,0,9447
Uttarakhand,2008,Kidnapping & Abduction - Women & Girls,02. Kidnapping & Abduction of Women & Girls,44,69,125,1,44,21,194,0,50,43,447,411,222,125,88,0,0,536
West Bengal,2008,Kidnapping & Abduction - Women & Girls,02. Kidnapping & Abduction of Women & Girls,440,200,1130,16,36,47,1330,0,2084,1554,6974,6336,1907,1130,476,0,0,7466
Andaman & Nicobar Islands,2009,Kidnapping & Abduction - Women & Girls,02. Kidnapping & Abduction of Women & Girls,2,7,2,0,0,0,9,0,13,8,30,30,14,2,2,0,0,32
Andhra Pradesh,2009,Kidnapping & Abduction - Women & Girls,02. Kidnapping & Abduction of Women & Girls,744,117,968,51,50,398,1085,0,589,546,2513,2393,1526,968,794,3,0,3358
Arunachal Pradesh,2009,Kidnapping & Abduction - Women & Girls,02. Kidnapping & Abduction of Women & Girls,5,8,31,1,4,0,39,0,20,31,400,379,28,31,9,0,0,410
Assam,2009,Kidnapping & Abduction - Women & Girls,02. Kidnapping & Abduction of Women & Girls,319,572,774,52,77,228,1346,13,3354,2849,3082,2756,2092,774,396,0,0,3530
Bihar,2009,Kidnapping & Abduction - Women & Girls,02. Kidnapping & Abduction of Women & Girls,526,464,772,11,114,354,1236,0,1846,1450,3683,3562,1986,772,640,0,0,4334
Chandigarh,2009,Kidnapping & Abduction - Women & Girls,02. Kidnapping & Abduction of Women & Girls,13,1,17,0,11,15,18,0,34,31,46,53,36,17,24,0,0,70
Chhattisgarh,2009,Kidnapping & Abduction - Women & Girls,02. Kidnapping & Abduction of Women & Girls,81,18,173,0,40,25,191,0,77,64,689,637,229,173,121,0,0,810
Dadra & Nagar Haveli,2009,Kidnapping & Abduction - Women & Girls,02. Kidnapping & Abduction of Women & Girls,1,0,10,0,2,1,10,0,8,10,28,21,9,10,3,0,0,31
Daman & Diu,2009,Kidnapping & Abduction - Women & Girls,02. Kidnapping & Abduction of Women & Girls,0,0,0,0,0,0,0,0,2,2,2,2,0,0,0,0,0,2
Delhi,2009,Kidnapping & Abduction - Women & Girls,02. Kidnapping & Abduction of Women & Girls,104,604,293,0,46,354,897,37,2247,1941,1531,1388,1655,293,150,0,61,1681
Goa,2009,Kidnapping & Abduction - Women & Girls,02. Kidnapping & Abduction of Women & Girls,12,8,13,0,0,3,21,0,24,26,34,33,22,13,12,0,0,46
Gujarat,2009,Kidnapping & Abduction - Women & Girls,02. Kidnapping & Abduction of Women & Girls,294,211,808,8,42,64,1019,9,365,295,6609,6145,1162,808,336,0,0,6953
Haryana,2009,Kidnapping & Abduction - Women & Girls,02. Kidnapping & Abduction of Women & Girls,210,21,339,0,74,286,360,0,196,183,888,833,659,339,284,0,0,1172
Himachal Pradesh,2009,Kidnapping & Abduction - Women & Girls,02. Kidnapping & Abduction of Women & Girls,39,4,66,2,5,63,70,0,44,55,212,192,122,66,44,0,0,258
Jammu & Kashmir,2009,Kidnapping & Abduction - Women & Girls,02. Kidnapping & Abduction of Women & Girls,370,23,427,1,11,390,450,0,482,497,3635,3590,825,427,381,0,0,4017
Jharkhand,2009,Kidnapping & Abduction - Women & Girls,02. Kidnapping & Abduction of Women & Girls,295,87,366,35,129,53,453,0,343,332,729,822,517,366,424,0,0,1188
Karnataka,2009,Kidnapping & Abduction - Women & Girls,02. Kidnapping & Abduction of Women & Girls,136,59,245,8,5,96,304,4,191,187,852,756,408,245,141,0,0,1001
Kerala,2009,Kidnapping & Abduction - Women & Girls,02. Kidnapping & Abduction of Women & Girls,81,11,131,1,8,13,142,0,106,88,701,660,173,131,89,0,0,791
Lakshadweep,2009,Kidnapping & Abduction - Women & Girls,02. Kidnapping & Abduction of Women & Girls,0,0,1,0,0,0,1,0,0,1,1,0,0,1,0,0,0,1
Madhya Pradesh,2009,Kidnapping & Abduction - Women & Girls,02. Kidnapping & Abduction of Women & Girls,285,68,679,13,121,19,747,0,265,190,2252,1992,841,679,406,0,0,2671
Maharashtra,2009,Kidnapping & Abduction - Women & Girls,02. Kidnapping & Abduction of Women & Girls,292,129,722,11,31,89,851,1,550,565,6290,5902,926,722,323,0,0,6624
Manipur,2009,Kidnapping & Abduction - Women & Girls,02. Kidnapping & Abduction of Women & Girls,0,33,1,0,0,0,34,0,317,254,23,22,97,1,0,0,0,23
Meghalaya,2009,Kidnapping & Abduction - Women & Girls,02. Kidnapping & Abduction of Women & Girls,13,6,5,0,0,0,11,0,97,82,82,90,26,5,13,0,0,95
Mizoram,2009,Kidnapping & Abduction - Women & Girls,02. Kidnapping & Abduction of Women & Girls,0,0,0,0,1,0,0,0,0,0,0,1,0,0,1,0,0,1
Nagaland,2009,Kidnapping & Abduction - Women & Girls,02. Kidnapping & Abduction of Women & Girls,0,2,8,0,1,0,10,0,6,6,12,5,10,8,1,0,0,13
Odisha,2009,Kidnapping & Abduction - Women & Girls,02. Kidnapping & Abduction of Women & Girls,236,15,485,0,40,55,500,0,921,677,2127,1918,799,485,276,0,0,2403
Puducherry,2009,Kidnapping & Abduction - Women & Girls,02. Kidnapping & Abduction of Women & Girls,3,1,13,0,0,4,14,1,4,10,32,22,13,13,3,0,0,35
Punjab,2009,Kidnapping & Abduction - Women & Girls,02. Kidnapping & Abduction of Women & Girls,158,87,212,0,34,184,299,0,359,329,965,945,513,212,192,0,0,1157
Rajasthan,2009,Kidnapping & Abduction - Women & Girls,02. Kidnapping & Abduction of Women & Girls,243,223,732,9,120,1298,955,0,231,174,4104,3744,2310,732,363,0,0,4476
Sikkim,2009,Kidnapping & Abduction - Women & Girls,02. Kidnapping & Abduction of Women & Girls,2,0,3,0,2,0,3,0,11,8,13,14,6,3,4,0,0,17
Tamil Nadu,2009,Kidnapping & Abduction - Women & Girls,02. Kidnapping & Abduction of Women & Girls,246,262,527,11,56,319,789,0,662,637,1102,888,1133,527,302,0,0,1415
Tripura,2009,Kidnapping & Abduction - Women & Girls,02. Kidnapping & Abduction of Women & Girls,32,21,71,0,6,0,92,0,28,28,178,145,92,71,38,0,0,216
Uttar Pradesh,2009,Kidnapping & Abduction - Women & Girls,02. Kidnapping & Abduction of Women & Girls,1244,1283,2941,8,1251,722,4224,0,717,585,7645,7207,5078,2941,2495,0,0,10148
Uttarakhand,2009,Kidnapping & Abduction - Women & Girls,02. Kidnapping & Abduction of Women & Girls,47,76,150,10,36,26,226,0,45,50,504,447,247,150,83,0,0,597
West Bengal,2009,Kidnapping & Abduction - Women & Girls,02. Kidnapping & Abduction of Women & Girls,369,321,1137,13,31,54,1458,1,2758,2084,7698,6974,2187,1137,400,0,0,8111
Andaman & Nicobar Islands,2010,Kidnapping & Abduction - Women & Girls,02. Kidnapping & Abduction of Women & Girls,0,3,7,0,0,0,10,0,11,13,37,30,8,7,0,0,0,37
Andhra Pradesh,2010,Kidnapping & Abduction - Women & Girls,02. Kidnapping & Abduction of Women & Girls,749,58,1101,58,75,410,1159,0,551,589,2732,2513,1531,1101,824,0,0,3614
Arunachal Pradesh,2010,Kidnapping & Abduction - Women & Girls,02. Kidnapping & Abduction of Women & Girls,2,15,21,5,2,0,36,0,30,20,412,400,46,21,4,0,0,421
Assam,2010,Kidnapping & Abduction - Women & Girls,02. Kidnapping & Abduction of Women & Girls,509,730,971,22,106,231,1701,63,4126,3354,3416,3082,2767,971,615,0,0,4053
Bihar,2010,Kidnapping & Abduction - Women & Girls,02. Kidnapping & Abduction of Women & Girls,581,593,1150,15,108,410,1743,0,2262,1846,4129,3683,2569,1150,689,0,0,4833
Chandigarh,2010,Kidnapping & Abduction - Women & Girls,02. Kidnapping & Abduction of Women & Girls,8,2,1,0,6,30,3,0,29,34,33,46,28,1,14,0,0,47
Chhattisgarh,2010,Kidnapping & Abduction - Women & Girls,02. Kidnapping & Abduction of Women & Girls,109,34,192,1,36,13,226,0,117,77,735,689,279,192,145,0,0,881
Dadra & Nagar Haveli,2010,Kidnapping & Abduction - Women & Girls,02. Kidnapping & Abduction of Women & Girls,2,0,3,0,1,2,3,0,13,8,28,28,10,3,3,0,0,31
Daman & Diu,2010,Kidnapping & Abduction - Women & Girls,02. Kidnapping & Abduction of Women & Girls,0,1,0,0,0,0,1,0,3,2,2,2,2,0,0,0,0,2
Delhi,2010,Kidnapping & Abduction - Women & Girls,02. Kidnapping & Abduction of Women & Girls,141,656,289,0,85,537,945,26,2407,2247,1594,1531,1740,289,226,0,72,1820
Goa,2010,Kidnapping & Abduction - Women & Girls,02. Kidnapping & Abduction of Women & Girls,8,7,10,0,1,3,17,0,22,24,35,34,18,10,9,0,0,44
Gujarat,2010,Kidnapping & Abduction - Women & Girls,02. Kidnapping & Abduction of Women & Girls,350,229,1027,17,51,50,1256,10,338,365,7218,6609,1290,1027,401,0,1,7636
Haryana,2010,Kidnapping & Abduction - Women & Girls,02. Kidnapping & Abduction of Women & Girls,259,21,431,0,91,260,452,0,198,196,969,888,714,431,350,0,0,1319
Himachal Pradesh,2010,Kidnapping & Abduction - Women & Girls,02. Kidnapping & Abduction of Women & Girls,28,3,55,3,5,83,58,0,65,44,231,212,162,55,33,0,0,267
Jammu & Kashmir,2010,Kidnapping & Abduction - Women & Girls,02. Kidnapping & Abduction of Women & Girls,250,31,346,5,5,423,377,0,522,482,3721,3635,840,346,255,0,0,3981
Jharkhand,2010,Kidnapping & Abduction - Women & Girls,02. Kidnapping & Abduction of Women & Girls,309,108,420,0,67,63,528,0,448,343,773,729,696,420,376,0,0,1149
Karnataka,2010,Kidnapping & Abduction - Women & Girls,02. Kidnapping & Abduction of Women & Girls,186,105,328,3,14,137,433,8,197,191,977,852,586,328,200,0,2,1180
Kerala,2010,Kidnapping & Abduction - Women & Girls,02. Kidnapping & Abduction of Women & Girls,72,12,174,0,4,17,186,0,87,106,799,701,184,174,76,0,0,875
Lakshadweep,2010,Kidnapping & Abduction - Women & Girls,02. Kidnapping & Abduction of Women & Girls,0,0,0,0,0,0,0,0,0,0,1,1,0,0,0,0,0,1
Madhya Pradesh,2010,Kidnapping & Abduction - Women & Girls,02. Kidnapping & Abduction of Women & Girls,433,86,856,11,208,20,942,0,333,265,2456,2252,1030,856,641,0,0,3108
Maharashtra,2010,Kidnapping & Abduction - Women & Girls,02. Kidnapping & Abduction of Women & Girls,366,138,706,9,21,99,844,9,722,550,6600,6290,1124,706,387,0,0,6996
Manipur,2010,Kidnapping & Abduction - Women & Girls,02. Kidnapping & Abduction of Women & Girls,2,38,2,0,0,0,40,0,384,317,23,23,107,2,2,0,0,25
Meghalaya,2010,Kidnapping & Abduction - Women & Girls,02. Kidnapping & Abduction of Women & Girls,6,1,9,0,0,0,10,0,124,97,85,82,37,9,6,0,0,91
Mizoram,2010,Kidnapping & Abduction - Women & Girls,02. Kidnapping & Abduction of Women & Girls,0,0,0,0,0,0,0,0,0,0,0,0,0,0,0,0,0,0
Nagaland,2010,Kidnapping & Abduction - Women & Girls,02. Kidnapping & Abduction of Women & Girls,10,1,8,0,4,0,9,0,3,6,6,12,6,8,14,0,0,20
Odisha,2010,Kidnapping & Abduction - Women & Girls,02. Kidnapping & Abduction of Women & Girls,371,23,811,0,31,120,834,0,879,921,2536,2127,912,811,402,0,0,2938
Puducherry,2010,Kidnapping & Abduction - Women & Girls,02. Kidnapping & Abduction of Women & Girls,3,0,13,0,2,2,13,0,3,4,40,32,14,13,5,0,0,45
Punjab,2010,Kidnapping & Abduction - Women & Girls,02. Kidnapping & Abduction of Women & Girls,123,120,226,0,47,207,346,0,339,316,911,855,576,226,170,0,0,1081
Rajasthan,2010,Kidnapping & Abduction - Women & Girls,02. Kidnapping & Abduction of Women & Girls,244,196,815,31,128,1374,1011,0,323,231,4516,4104,2477,815,372,0,0,4919
Sikkim,2010,Kidnapping & Abduction - Women & Girls,02. Kidnapping & Abduction of Women & Girls,1,1,10,1,1,0,11,0,6,11,20,13,6,10,2,0,0,23
Tamil Nadu,2010,Kidnapping & Abduction - Women & Girls,02. Kidnapping & Abduction of Women & Girls,325,246,619,9,104,316,865,0,945,662,1283,1102,1464,619,429,0,0,1721
Tripura,2010,Kidnapping & Abduction - Women & Girls,02. Kidnapping & Abduction of Women & Girls,33,14,57,0,3,3,71,0,45,28,199,178,91,57,36,0,0,235
Uttar Pradesh,2010,Kidnapping & Abduction - Women & Girls,02. Kidnapping & Abduction of Women & Girls,1458,1525,3050,14,1594,565,4575,0,1045,717,7629,7645,5468,3050,3052,0,0,10695
Uttarakhand,2010,Kidnapping & Abduction - Women & Girls,02. Kidnapping & Abduction of Women & Girls,57,91,147,0,36,14,238,0,42,45,558,504,249,147,93,0,0,651
West Bengal,2010,Kidnapping & Abduction - Women & Girls,02. Kidnapping & Abduction of Women & Girls,353,435,2069,21,37,66,2504,0,2952,2758,9356,7698,2764,2069,390,0,0,9767
Andaman & Nicobar Islands,2001,Dowry Deaths,03. Dowry Deaths,0,0,0,0,0,0,0,0,0,0,2,2,0,0,0,0,0,2
Andhra Pradesh,2001,Dowry Deaths,03. Dowry Deaths,324,10,366,12,87,15,376,0,227,198,1074,1131,420,366,411,0,0,1497
Arunachal Pradesh,2001,Dowry Deaths,03. Dowry Deaths,0,0,0,0,0,0,0,0,0,0,0,0,0,0,0,0,0,0
Assam,2001,Dowry Deaths,03. Dowry Deaths,13,0,28,0,8,1,28,0,84,54,94,87,59,28,21,0,0,115
Bihar,2001,Dowry Deaths,03. Dowry Deaths,253,107,670,18,146,82,777,0,494,494,2309,2056,859,670,399,0,0,2726
Chandigarh,2001,Dowry Deaths,03. Dowry Deaths,0,0,2,0,2,0,2,0,1,0,7,7,3,2,2,0,0,9
Chhattisgarh,2001,Dowry Deaths,03. Dowry Deaths,31,0,66,0,15,0,66,0,13,9,213,193,70,66,46,0,0,259
Dadra & Nagar Haveli,2001,Dowry Deaths,03. Dowry Deaths,0,0,0,0,1,0,0,0,0,0,2,3,0,0,1,0,0,3
Daman & Diu,2001,Dowry Deaths,03. Dowry Deaths,0,0,0,0,0,0,0,0,0,0,0,0,0,0,0,0,0,0
Delhi,2001,Dowry Deaths,03. Dowry Deaths,32,11,131,0,58,0,142,0,49,78,505,464,113,131,90,0,0,595
Goa,2001,Dowry Deaths,03. Dowry Deaths,2,0,2,0,1,1,2,0,0,1,8,9,2,2,3,0,0,11
Gujarat,2001,Dowry Deaths,03. Dowry Deaths,21,0,67,4,1,1,67,0,6,7,481,440,67,67,22,0,0,507
Haryana,2001,Dowry Deaths,03. Dowry Deaths,250,2,265,9,52,25,267,0,22,29,661,707,285,265,302,0,0,972
Himachal Pradesh,2001,Dowry Deaths,03. Dowry Deaths,4,0,6,0,0,3,6,0,4,3,26,24,10,6,4,0,0,30
Jammu & Kashmir,2001,Dowry Deaths,03. Dowry Deaths,7,1,16,1,0,0,17,0,1,5,15,7,13,16,7,0,0,23
Jharkhand,2001,Dowry Deaths,03. Dowry Deaths,126,16,237,0,50,7,253,0,83,126,410,349,217,237,176,0,0,586
Karnataka,2001,Dowry Deaths,03. Dowry Deaths,109,9,216,4,13,9,225,7,66,87,636,559,220,216,122,13,0,762
Kerala,2001,Dowry Deaths,03. Dowry Deaths,8,1,27,0,6,0,28,0,20,21,119,106,27,27,14,0,0,133
Lakshadweep,2001,Dowry Deaths,03. Dowry Deaths,0,0,0,0,0,0,0,0,0,0,0,0,0,0,0,0,0,0
Madhya Pradesh,2001,Dowry Deaths,03. Dowry Deaths,452,9,592,2,165,4,601,0,124,122,1638,1665,609,592,617,0,2,2257
Maharashtra,2001,Dowry Deaths,03. Dowry Deaths,326,3,327,13,34,0,330,0,93,115,3060,3106,308,327,360,0,0,3433
Manipur,2001,Dowry Deaths,03. Dowry Deaths,0,0,0,0,0,0,0,0,0,0,0,0,0,0,0,0,0,0
Meghalaya,2001,Dowry Deaths,03. Dowry Deaths,0,0,0,0,0,0,0,0,1,1,0,0,0,0,0,0,0,0
Mizoram,2001,Dowry Deaths,03. Dowry Deaths,0,0,0,0,0,0,0,0,0,0,0,0,0,0,0,0,0,0
Nagaland,2001,Dowry Deaths,03. Dowry Deaths,0,0,0,0,0,0,0,0,0,0,0,0,0,0,0,0,0,0
Odisha,2001,Dowry Deaths,03. Dowry Deaths,148,18,288,0,34,5,306,0,125,142,735,629,294,288,182,0,0,917
Puducherry,2001,Dowry Deaths,03. Dowry Deaths,4,0,4,0,2,0,4,0,0,3,4,6,1,4,6,0,0,10
Punjab,2001,Dowry Deaths,03. Dowry Deaths,79,7,140,1,50,12,147,0,95,95,335,325,159,140,129,0,0,465
Rajasthan,2001,Dowry Deaths,03. Dowry Deaths,170,4,306,1,106,94,310,0,45,73,1316,1287,376,306,276,0,0,1593
Sikkim,2001,Dowry Deaths,03. Dowry Deaths,0,0,0,0,0,0,0,0,0,0,0,0,0,0,0,0,0,0
Tamil Nadu,2001,Dowry Deaths,03. Dowry Deaths,98,6,174,6,44,4,180,3,100,96,557,531,191,174,142,0,0,705
Tripura,2001,Dowry Deaths,03. Dowry Deaths,7,2,13,0,2,0,15,0,26,25,31,27,16,13,9,0,0,40
Uttar Pradesh,2001,Dowry Deaths,03. Dowry Deaths,800,265,1784,101,727,135,2049,0,445,418,7226,7070,2211,1784,1527,0,0,8854
Uttarakhand,2001,Dowry Deaths,03. Dowry Deaths,36,3,54,8,24,2,57,0,7,10,133,147,56,54,60,0,0,201
West Bengal,2001,Dowry Deaths,03. Dowry Deaths,139,5,279,0,25,0,284,0,269,288,1100,985,265,279,164,0,0,1264
Andaman & Nicobar Islands,2002,Dowry Deaths,03. Dowry Deaths,0,0,0,0,0,0,0,0,0,0,2,2,0,0,0,0,0,2
Andhra Pradesh,2002,Dowry Deaths,03. Dowry Deaths,360,5,443,7,61,22,448,3,203,227,1089,1074,449,443,421,0,0,1517
Arunachal Pradesh,2002,Dowry Deaths,03. Dowry Deaths,0,0,0,0,0,0,0,0,0,0,0,0,0,0,0,0,0,0
Assam,2002,Dowry Deaths,03. Dowry Deaths,10,6,36,0,6,1,42,0,111,84,114,94,70,36,16,0,0,130
Bihar,2002,Dowry Deaths,03. Dowry Deaths,245,102,650,1,80,76,752,0,593,494,2633,2309,927,650,325,0,0,2959
Chandigarh,2002,Dowry Deaths,03. Dowry Deaths,2,1,0,0,2,0,1,0,1,1,3,7,1,0,4,0,0,7
Chhattisgarh,2002,Dowry Deaths,03. Dowry Deaths,49,3,83,5,22,0,86,1,11,13,220,213,85,83,71,0,0,296
Dadra & Nagar Haveli,2002,Dowry Deaths,03. Dowry Deaths,0,0,0,0,0,0,0,0,0,0,2,2,0,0,0,0,0,2
Daman & Diu,2002,Dowry Deaths,03. Dowry Deaths,0,0,0,0,0,0,0,0,0,0,0,0,0,0,0,0,0,0
Delhi,2002,Dowry Deaths,03. Dowry Deaths,15,5,122,0,12,0,127,0,57,49,600,505,135,122,27,0,0,627
Goa,2002,Dowry Deaths,03. Dowry Deaths,0,0,0,0,0,0,0,0,2,0,8,8,2,0,0,0,0,8
Gujarat,2002,Dowry Deaths,03. Dowry Deaths,39,5,59,3,3,0,64,0,4,6,495,481,62,59,42,0,0,540
Haryana,2002,Dowry Deaths,03. Dowry Deaths,210,2,227,15,59,29,229,0,20,22,604,661,256,227,269,0,0,888
Himachal Pradesh,2002,Dowry Deaths,03. Dowry Deaths,0,0,7,0,3,1,7,0,2,4,30,26,6,7,3,0,0,33
Jammu & Kashmir,2002,Dowry Deaths,03. Dowry Deaths,4,0,11,0,1,0,11,0,8,1,21,15,18,11,5,0,0,26
Jharkhand,2002,Dowry Deaths,03. Dowry Deaths,154,14,238,0,78,8,252,0,94,79,461,455,275,238,232,0,0,693
Karnataka,2002,Dowry Deaths,03. Dowry Deaths,131,6,198,0,13,6,204,19,70,66,690,636,233,198,144,0,0,834
Kerala,2002,Dowry Deaths,03. Dowry Deaths,7,1,17,1,2,0,18,0,19,20,126,119,17,17,9,0,0,136
Lakshadweep,2002,Dowry Deaths,03. Dowry Deaths,0,0,0,0,0,0,0,0,0,0,0,0,0,0,0,0,0,0
Madhya Pradesh,2002,Dowry Deaths,03. Dowry Deaths,391,4,696,7,203,3,700,0,95,124,1733,1638,674,696,594,0,0,2334
Maharashtra,2002,Dowry Deaths,03. Dowry Deaths,277,3,312,11,36,2,315,0,79,93,3048,3060,303,312,313,0,0,3372
Manipur,2002,Dowry Deaths,03. Dowry Deaths,0,0,0,0,0,0,0,0,0,0,0,0,0,0,0,0,0,0
Meghalaya,2002,Dowry Deaths,03. Dowry Deaths,0,0,0,0,0,0,0,0,1,1,0,0,0,0,0,0,0,0
Mizoram,2002,Dowry Deaths,03. Dowry Deaths,0,0,0,0,0,0,0,0,0,0,0,0,0,0,0,0,0,0
Nagaland,2002,Dowry Deaths,03. Dowry Deaths,0,0,0,0,0,0,0,0,0,0,0,0,0,0,0,0,0,0
Odisha,2002,Dowry Deaths,03. Dowry Deaths,138,2,231,0,32,5,233,0,135,125,796,735,248,231,170,0,0,966
Puducherry,2002,Dowry Deaths,03. Dowry Deaths,2,0,3,0,0,0,3,0,2,0,5,4,5,3,2,0,0,7
Punjab,2002,Dowry Deaths,03. Dowry Deaths,68,15,128,2,70,12,143,0,106,95,323,335,166,128,138,0,0,463
Rajasthan,2002,Dowry Deaths,03. Dowry Deaths,189,2,298,2,139,87,300,0,57,45,1284,1316,399,298,328,0,0,1614
Sikkim,2002,Dowry Deaths,03. Dowry Deaths,0,0,0,0,0,0,0,0,0,0,0,0,0,0,0,0,0,0
Tamil Nadu,2002,Dowry Deaths,03. Dowry Deaths,137,6,244,0,76,7,250,2,84,100,588,557,243,244,213,0,0,801
Tripura,2002,Dowry Deaths,03. Dowry Deaths,9,1,18,0,7,0,19,0,23,26,33,31,16,18,16,0,0,49
Uttar Pradesh,2002,Dowry Deaths,03. Dowry Deaths,929,184,1818,65,902,136,2002,0,200,445,7148,7226,1893,1818,1831,0,0,9044
Uttarakhand,2002,Dowry Deaths,03. Dowry Deaths,19,8,53,0,30,1,61,0,11,7,137,133,66,53,49,0,0,186
West Bengal,2002,Dowry Deaths,03. Dowry Deaths,237,35,273,0,33,0,308,0,234,269,1103,1100,273,273,270,0,0,1373
Andaman & Nicobar Islands,2003,Dowry Deaths,03. Dowry Deaths,0,0,0,0,0,0,0,0,0,0,2,2,0,0,0,0,0,2
Andhra Pradesh,2003,Dowry Deaths,03. Dowry Deaths,336,9,362,3,71,35,371,0,263,203,1041,1089,466,362,407,0,0,1451
Arunachal Pradesh,2003,Dowry Deaths,03. Dowry Deaths,0,0,0,0,0,0,0,0,0,0,0,0,0,0,0,0,0,0
Assam,2003,Dowry Deaths,03. Dowry Deaths,18,13,32,0,8,1,45,0,125,111,120,114,60,32,26,0,0,146
Bihar,2003,Dowry Deaths,03. Dowry Deaths,390,128,595,15,101,57,723,0,722,593,2722,2633,909,595,491,0,0,3228
Chandigarh,2003,Dowry Deaths,03. Dowry Deaths,0,1,1,0,0,0,2,0,0,1,4,3,1,1,0,0,0,4
Chhattisgarh,2003,Dowry Deaths,03. Dowry Deaths,20,0,80,6,20,0,80,0,10,11,254,220,79,80,40,0,0,300
Dadra & Nagar Haveli,2003,Dowry Deaths,03. Dowry Deaths,0,0,0,0,0,0,0,0,0,0,2,2,0,0,0,0,0,2
Daman & Diu,2003,Dowry Deaths,03. Dowry Deaths,0,0,0,0,0,0,0,0,1,0,0,0,1,0,0,0,0,0
Delhi,2003,Dowry Deaths,03. Dowry Deaths,23,7,123,0,9,0,130,0,57,57,691,600,130,123,32,0,0,723
Goa,2003,Dowry Deaths,03. Dowry Deaths,1,0,2,0,0,0,2,0,2,2,9,8,2,2,1,0,0,10
Gujarat,2003,Dowry Deaths,03. Dowry Deaths,44,2,49,2,4,1,51,0,6,4,494,495,54,49,48,0,0,544
Haryana,2003,Dowry Deaths,03. Dowry Deaths,151,1,202,0,60,32,203,0,7,20,595,604,222,202,211,0,0,806
Himachal Pradesh,2003,Dowry Deaths,03. Dowry Deaths,7,0,6,0,0,0,6,0,2,2,29,30,6,6,7,0,0,36
Jammu & Kashmir,2003,Dowry Deaths,03. Dowry Deaths,9,0,14,0,4,0,14,0,4,8,22,21,10,14,13,0,0,35
Jharkhand,2003,Dowry Deaths,03. Dowry Deaths,133,7,225,13,52,3,232,0,121,94,488,461,262,225,185,0,0,686
Karnataka,2003,Dowry Deaths,03. Dowry Deaths,138,8,177,3,24,3,185,12,64,70,702,690,194,177,162,0,0,867
Kerala,2003,Dowry Deaths,03. Dowry Deaths,7,1,17,0,4,0,18,1,33,19,132,126,33,17,11,0,0,143
Lakshadweep,2003,Dowry Deaths,03. Dowry Deaths,0,0,0,0,0,0,0,0,0,0,0,0,0,0,0,0,0,0
Madhya Pradesh,2003,Dowry Deaths,03. Dowry Deaths,446,11,601,25,217,0,612,0,124,88,1637,1724,648,601,663,0,0,2325
Maharashtra,2003,Dowry Deaths,03. Dowry Deaths,319,2,367,10,81,0,369,0,78,79,3005,3048,368,367,400,0,0,3415
Manipur,2003,Dowry Deaths,03. Dowry Deaths,0,0,0,0,0,0,0,0,0,0,0,0,0,0,0,0,0,0
Meghalaya,2003,Dowry Deaths,03. Dowry Deaths,0,0,0,0,0,0,0,0,1,1,0,0,0,0,0,0,0,0
Mizoram,2003,Dowry Deaths,03. Dowry Deaths,0,0,0,0,0,0,0,0,0,0,0,0,0,0,0,0,0,0
Nagaland,2003,Dowry Deaths,03. Dowry Deaths,0,0,0,0,0,0,0,0,0,0,0,0,0,0,0,0,0,0
Odisha,2003,Dowry Deaths,03. Dowry Deaths,138,4,286,0,48,12,290,0,112,135,896,796,279,286,186,0,0,1082
Puducherry,2003,Dowry Deaths,03. Dowry Deaths,0,0,1,0,0,0,1,0,2,2,6,5,1,1,0,0,0,6
Punjab,2003,Dowry Deaths,03. Dowry Deaths,80,2,125,5,101,11,127,0,78,106,262,323,110,125,181,0,0,448
Rajasthan,2003,Dowry Deaths,03. Dowry Deaths,169,6,270,3,121,90,276,0,80,57,1261,1284,389,270,290,0,0,1554
Sikkim,2003,Dowry Deaths,03. Dowry Deaths,0,0,0,0,0,0,0,0,0,0,0,0,0,0,0,0,0,0
Tamil Nadu,2003,Dowry Deaths,03. Dowry Deaths,178,7,217,1,66,2,224,0,82,88,570,598,220,217,244,0,0,815
Tripura,2003,Dowry Deaths,03. Dowry Deaths,5,0,17,0,7,0,17,0,26,23,38,33,20,17,12,0,0,50
Uttar Pradesh,2003,Dowry Deaths,03. Dowry Deaths,759,93,1111,46,649,63,1204,0,255,200,6805,7148,1322,1111,1408,0,0,8259
Uttarakhand,2003,Dowry Deaths,03. Dowry Deaths,13,9,79,0,25,1,88,0,15,11,178,137,93,79,38,0,0,216
West Bengal,2003,Dowry Deaths,03. Dowry Deaths,182,7,313,0,36,1,320,1,241,234,1198,1103,329,313,218,0,0,1416
Andaman & Nicobar Islands,2004,Dowry Deaths,03. Dowry Deaths,0,0,0,0,1,0,0,0,0,0,1,2,0,0,1,0,0,2
Andhra Pradesh,2004,Dowry Deaths,03. Dowry Deaths,341,26,417,2,66,37,443,0,295,263,1049,1041,512,417,407,0,0,1458
Arunachal Pradesh,2004,Dowry Deaths,03. Dowry Deaths,0,0,0,0,0,0,0,0,0,0,0,0,0,0,0,0,0,0
Assam,2004,Dowry Deaths,03. Dowry Deaths,18,10,63,0,14,5,73,0,121,125,151,120,74,63,32,0,0,183
Bihar,2004,Dowry Deaths,03. Dowry Deaths,351,68,490,2,88,65,558,0,1128,722,2771,2722,1029,490,439,0,0,3212
Chandigarh,2004,Dowry Deaths,03. Dowry Deaths,2,0,4,0,0,0,4,0,2,0,6,4,6,4,2,0,0,8
Chhattisgarh,2004,Dowry Deaths,03. Dowry Deaths,57,1,78,1,32,0,79,0,2,10,242,254,71,78,89,0,0,332
Dadra & Nagar Haveli,2004,Dowry Deaths,03. Dowry Deaths,0,0,0,0,0,0,0,0,0,0,2,2,0,0,0,0,0,2
Daman & Diu,2004,Dowry Deaths,03. Dowry Deaths,0,0,0,0,0,0,0,0,1,1,0,0,0,0,0,0,0,0
Delhi,2004,Dowry Deaths,03. Dowry Deaths,43,0,118,0,29,0,118,0,65,57,737,691,126,118,72,0,0,809
Goa,2004,Dowry Deaths,03. Dowry Deaths,4,1,0,0,0,0,1,0,3,2,5,9,2,0,4,0,0,9
Gujarat,2004,Dowry Deaths,03. Dowry Deaths,49,1,57,1,5,1,58,0,5,6,496,494,58,57,54,0,0,551
Haryana,2004,Dowry Deaths,03. Dowry Deaths,220,4,209,0,63,21,213,0,24,7,521,595,251,209,283,0,0,804
Himachal Pradesh,2004,Dowry Deaths,03. Dowry Deaths,6,0,7,0,1,1,7,0,2,2,29,29,8,7,7,0,0,36
Jammu & Kashmir,2004,Dowry Deaths,03. Dowry Deaths,11,0,9,0,2,0,9,0,4,4,18,22,9,9,13,0,0,31
Jharkhand,2004,Dowry Deaths,03. Dowry Deaths,133,7,225,13,52,3,232,0,161,121,515,488,275,225,185,0,0,713
Karnataka,2004,Dowry Deaths,03. Dowry Deaths,198,15,214,1,35,9,229,15,68,64,682,702,259,214,233,0,2,916
Kerala,2004,Dowry Deaths,03. Dowry Deaths,8,1,39,0,5,2,40,0,22,33,158,132,31,39,13,0,0,171
Lakshadweep,2004,Dowry Deaths,03. Dowry Deaths,0,0,0,0,0,0,0,0,0,0,0,0,0,0,0,0,0,0
Madhya Pradesh,2004,Dowry Deaths,03. Dowry Deaths,505,7,753,5,260,1,760,0,114,124,1620,1637,751,753,765,0,0,2390
Maharashtra,2004,Dowry Deaths,03. Dowry Deaths,285,0,322,1,36,0,322,0,70,78,3005,3005,314,322,321,0,0,3327
Manipur,2004,Dowry Deaths,03. Dowry Deaths,0,0,0,0,0,0,0,0,0,0,0,0,0,0,0,0,0,0
Meghalaya,2004,Dowry Deaths,03. Dowry Deaths,0,0,0,0,0,0,0,0,3,1,0,0,2,0,0,0,0,0
Mizoram,2004,Dowry Deaths,03. Dowry Deaths,0,0,0,0,0,0,0,0,0,0,0,0,0,0,0,0,0,0
Nagaland,2004,Dowry Deaths,03. Dowry Deaths,0,0,0,0,0,0,0,0,0,0,0,0,0,0,0,0,0,0
Odisha,2004,Dowry Deaths,03. Dowry Deaths,202,2,298,0,44,15,300,0,116,112,948,896,319,298,246,0,0,1194
Puducherry,2004,Dowry Deaths,03. Dowry Deaths,1,0,3,0,0,0,3,0,5,2,8,6,6,3,1,0,0,9
Punjab,2004,Dowry Deaths,03. Dowry Deaths,45,5,104,3,47,10,109,0,72,78,271,262,113,104,92,0,0,366
Rajasthan,2004,Dowry Deaths,03. Dowry Deaths,165,1,320,6,126,68,321,0,70,80,1284,1261,379,320,291,0,0,1581
Sikkim,2004,Dowry Deaths,03. Dowry Deaths,0,0,0,0,0,0,0,0,0,0,0,0,0,0,0,0,0,0
Tamil Nadu,2004,Dowry Deaths,03. Dowry Deaths,134,10,213,0,42,0,223,0,84,82,607,570,225,213,176,0,0,783
Tripura,2004,Dowry Deaths,03. Dowry Deaths,8,5,22,0,1,0,27,0,19,26,51,38,20,22,9,0,0,60
Uttar Pradesh,2004,Dowry Deaths,03. Dowry Deaths,707,172,1393,69,727,118,1565,0,280,255,6695,6805,1708,1393,1434,0,0,8198
Uttarakhand,2004,Dowry Deaths,03. Dowry Deaths,13,7,65,0,30,9,72,0,16,15,200,178,82,65,43,0,0,243
West Bengal,2004,Dowry Deaths,03. Dowry Deaths,165,4,344,0,29,0,348,0,289,241,1348,1198,396,344,194,0,0,1542
Andaman & Nicobar Islands,2005,Dowry Deaths,03. Dowry Deaths,0,0,0,0,0,0,0,0,0,0,1,1,0,0,0,0,0,1
Andhra Pradesh,2005,Dowry Deaths,03. Dowry Deaths,429,7,473,3,118,20,480,0,238,295,972,1049,443,473,547,0,0,1522
Arunachal Pradesh,2005,Dowry Deaths,03. Dowry Deaths,0,0,0,0,0,0,0,0,0,0,0,0,0,0,0,0,0,0
Assam,2005,Dowry Deaths,03. Dowry Deaths,23,12,61,0,15,6,73,0,141,121,174,151,99,61,38,0,0,212
Bihar,2005,Dowry Deaths,03. Dowry Deaths,391,53,680,3,110,46,733,0,1363,1128,2947,2771,1014,680,501,0,0,3451
Chandigarh,2005,Dowry Deaths,03. Dowry Deaths,6,0,4,0,0,0,4,0,1,2,4,6,3,4,6,0,0,10
Chhattisgarh,2005,Dowry Deaths,03. Dowry Deaths,36,1,91,3,26,0,92,0,10,2,268,242,100,91,62,0,0,333
Dadra & Nagar Haveli,2005,Dowry Deaths,03. Dowry Deaths,1,0,0,0,0,0,0,0,0,0,1,2,0,0,1,0,0,2
Daman & Diu,2005,Dowry Deaths,03. Dowry Deaths,0,0,1,0,0,0,1,0,1,1,2,1,1,1,0,0,0,2
Delhi,2005,Dowry Deaths,03. Dowry Deaths,85,2,95,0,40,1,97,0,81,65,707,737,114,95,125,0,0,832
Goa,2005,Dowry Deaths,03. Dowry Deaths,2,0,3,0,0,0,3,0,2,3,6,5,2,3,2,0,0,8
Gujarat,2005,Dowry Deaths,03. Dowry Deaths,55,0,48,0,10,0,48,0,5,5,479,496,48,48,65,0,0,544
Haryana,2005,Dowry Deaths,03. Dowry Deaths,196,3,185,0,52,31,188,0,17,24,458,521,212,185,248,0,0,706
Himachal Pradesh,2005,Dowry Deaths,03. Dowry Deaths,3,0,1,0,1,1,1,0,2,2,26,29,2,1,4,0,0,30
Jammu & Kashmir,2005,Dowry Deaths,03. Dowry Deaths,1,0,7,0,1,0,7,0,2,4,23,18,5,7,2,0,0,25
Jharkhand,2005,Dowry Deaths,03. Dowry Deaths,15,18,166,10,71,2,184,0,232,161,585,515,257,166,86,0,0,681
Karnataka,2005,Dowry Deaths,03. Dowry Deaths,261,8,233,0,63,2,241,9,77,68,591,682,261,233,324,0,0,915
Kerala,2005,Dowry Deaths,03. Dowry Deaths,24,0,18,0,10,0,18,0,25,22,142,158,21,18,34,0,0,176
Lakshadweep,2005,Dowry Deaths,03. Dowry Deaths,0,0,0,0,0,0,0,0,0,0,0,0,0,0,0,0,0,0
Madhya Pradesh,2005,Dowry Deaths,03. Dowry Deaths,476,7,715,19,262,4,722,0,127,114,1578,1620,739,715,738,0,0,2335
Maharashtra,2005,Dowry Deaths,03. Dowry Deaths,266,2,336,2,34,1,338,0,72,70,3039,3005,341,336,300,0,0,3341
Manipur,2005,Dowry Deaths,03. Dowry Deaths,0,0,0,0,0,0,0,0,0,0,0,0,0,0,0,0,0,0
Meghalaya,2005,Dowry Deaths,03. Dowry Deaths,0,0,0,0,0,0,0,0,4,3,0,0,1,0,0,0,0,0
Mizoram,2005,Dowry Deaths,03. Dowry Deaths,0,0,4,0,2,0,4,0,0,0,2,0,4,4,2,0,0,4
Nagaland,2005,Dowry Deaths,03. Dowry Deaths,0,0,0,0,0,0,0,0,0,0,0,0,0,0,0,0,0,0
Odisha,2005,Dowry Deaths,03. Dowry Deaths,175,4,268,0,35,10,272,0,168,116,1006,948,334,268,210,0,0,1216
Puducherry,2005,Dowry Deaths,03. Dowry Deaths,0,0,2,0,0,0,2,0,7,5,10,8,4,2,0,0,0,10
Punjab,2005,Dowry Deaths,03. Dowry Deaths,37,4,89,0,28,12,93,0,66,72,295,271,99,89,65,0,0,360
Rajasthan,2005,Dowry Deaths,03. Dowry Deaths,143,3,281,4,119,87,284,0,60,70,1299,1284,361,281,262,0,0,1565
Sikkim,2005,Dowry Deaths,03. Dowry Deaths,0,0,0,0,0,0,0,0,0,0,0,0,0,0,0,0,0,0
Tamil Nadu,2005,Dowry Deaths,03. Dowry Deaths,171,2,212,0,71,5,214,0,80,84,571,607,215,212,242,6,0,813
Tripura,2005,Dowry Deaths,03. Dowry Deaths,6,9,28,0,7,0,37,0,16,19,66,51,34,28,13,0,0,79
Uttar Pradesh,2005,Dowry Deaths,03. Dowry Deaths,621,127,1367,102,678,82,1494,0,268,280,6661,6695,1564,1367,1299,0,0,8062
Uttarakhand,2005,Dowry Deaths,03. Dowry Deaths,29,14,48,0,14,2,62,0,15,16,205,200,63,48,43,0,0,248
West Bengal,2005,Dowry Deaths,03. Dowry Deaths,267,15,389,0,94,0,404,0,331,289,1376,1348,446,389,361,0,0,1737
Andaman & Nicobar Islands,2006,Dowry Deaths,03. Dowry Deaths,0,0,0,0,0,0,0,0,0,0,1,1,0,0,0,0,0,1
Andhra Pradesh,2006,Dowry Deaths,03. Dowry Deaths,280,26,426,1,73,25,452,0,280,238,1044,972,519,426,353,0,0,1398
Arunachal Pradesh,2006,Dowry Deaths,03. Dowry Deaths,0,0,0,0,0,0,0,0,1,0,0,0,1,0,0,0,0,0
Assam,2006,Dowry Deaths,03. Dowry Deaths,21,16,74,2,30,3,90,0,153,141,195,174,105,74,51,0,0,248
Bihar,2006,Dowry Deaths,03. Dowry Deaths,512,80,749,1,138,38,829,0,1684,1363,3045,2947,1188,749,650,0,0,3696
Chandigarh,2006,Dowry Deaths,03. Dowry Deaths,3,0,9,0,0,0,9,0,2,1,10,4,10,9,3,0,0,13
Chhattisgarh,2006,Dowry Deaths,03. Dowry Deaths,48,0,99,4,23,0,99,0,14,10,292,268,103,99,71,0,0,367
Dadra & Nagar Haveli,2006,Dowry Deaths,03. Dowry Deaths,0,0,0,0,0,0,0,0,1,0,1,1,1,0,0,0,0,1
Daman & Diu,2006,Dowry Deaths,03. Dowry Deaths,0,0,1,0,0,0,1,0,0,1,2,1,0,1,0,0,0,2
Delhi,2006,Dowry Deaths,03. Dowry Deaths,73,9,134,0,47,4,143,0,71,81,721,707,137,134,120,0,0,841
Goa,2006,Dowry Deaths,03. Dowry Deaths,2,0,1,0,0,0,1,0,1,2,5,6,0,1,2,0,0,7
Gujarat,2006,Dowry Deaths,03. Dowry Deaths,31,4,43,1,3,1,47,1,6,5,487,479,50,43,34,0,0,522
Haryana,2006,Dowry Deaths,03. Dowry Deaths,129,1,215,2,69,22,216,0,34,17,473,458,255,215,198,0,0,673
Himachal Pradesh,2006,Dowry Deaths,03. Dowry Deaths,4,0,4,0,1,0,4,0,1,2,25,26,3,4,5,0,0,30
Jammu & Kashmir,2006,Dowry Deaths,03. Dowry Deaths,2,0,8,0,0,1,8,0,3,2,29,23,10,8,2,0,0,31
Jharkhand,2006,Dowry Deaths,03. Dowry Deaths,195,25,170,9,60,0,195,0,318,232,491,585,281,170,255,0,0,755
Karnataka,2006,Dowry Deaths,03. Dowry Deaths,242,8,213,1,41,7,221,11,80,77,520,591,244,213,283,0,2,804
Kerala,2006,Dowry Deaths,03. Dowry Deaths,19,2,21,0,6,1,23,0,26,25,138,142,25,21,25,0,0,163
Lakshadweep,2006,Dowry Deaths,03. Dowry Deaths,0,0,0,0,0,0,0,0,0,0,0,0,0,0,0,0,0,0
Madhya Pradesh,2006,Dowry Deaths,03. Dowry Deaths,398,7,735,7,280,2,742,0,147,127,1628,1578,764,735,678,0,0,2313
Maharashtra,2006,Dowry Deaths,03. Dowry Deaths,245,0,374,0,27,0,374,0,85,72,3141,3039,387,374,272,0,0,3413
Manipur,2006,Dowry Deaths,03. Dowry Deaths,0,0,0,0,0,0,0,0,0,0,0,0,0,0,0,0,0,0
Meghalaya,2006,Dowry Deaths,03. Dowry Deaths,0,1,3,0,0,0,4,0,6,4,3,0,6,3,0,0,0,3
Mizoram,2006,Dowry Deaths,03. Dowry Deaths,0,0,0,2,0,0,0,0,0,0,0,2,0,0,0,0,0,2
